alt	name
adolfo alsina	Adolfo Alsina
adolfo gonzales chaves	Adolfo Gonzales Chaves
alberti	Alberti
almirante brown	Almirante Brown
avellaneda, buenos aires	Avellaneda, Buenos Aires
ayacucho	Ayacucho
azul	Azul
bahía blanca	Bahía Blanca
balcarce	Balcarce
baradero	Baradero
arrecifes	Arrecifes
benito juárez	Benito Juárez
berazategui	Berazategui
berisso	Berisso
bolívar	Bolívar
bragado	Bragado
brandsen	Brandsen
campana	Campana
cañuelas	Cañuelas
capitán sarmiento	Capitán Sarmiento
carlos casares	Carlos Casares
carlos tejedor	Carlos Tejedor
carmen de areco	Carmen de Areco
castelli	Castelli
colón	Colón
coronel de marina leonardo rosales	Coronel de Marina Leonardo Rosales
coronel dorrego	Coronel Dorrego
coronel pringles	Coronel Pringles
coronel suárez	Coronel Suárez
chacabuco	Chacabuco
chascomús	Chascomús
chivilcoy	Chivilcoy
daireaux	Daireaux
dolores	Dolores
ensenada	Ensenada
escobar	Escobar
esteban echeverría	Esteban Echeverría
exaltación de la cruz	Exaltación de la Cruz
ezeiza	Ezeiza
florencio varela	Florencio Varela
florentino ameghino	Florentino Ameghino
general alvarado	General Alvarado
general alvear, buenos aires	General Alvear, Buenos Aires
general arenales	General Arenales
general belgrano, buenos aires	General Belgrano, Buenos Aires
general guido	General Guido
general juan madariaga	General Juan Madariaga
general la madrid	General la Madrid
general las  heras	General las  Heras
general lavalle	General Lavalle
general paz	General Paz
general pinto	General Pinto
general pueyrredón	General Pueyrredón
general rodríguez	General Rodríguez
general san martín, buenos aires	General San Martín, Buenos Aires
general viamonte	General Viamonte
general villegas	General Villegas
guaminí	Guaminí
hipólito yrigoyen, buenos aires	Hipólito Yrigoyen, Buenos Aires
hurlingham	Hurlingham
ituzaingó, buenos aires	Ituzaingó, Buenos Aires
josé c. paz	José C. Paz
junín, buenos aires	Junín, Buenos Aires
la costa	La Costa
la matanza	La Matanza
lanús	Lanús
la plata	La Plata
laprida	Laprida
las flores	Las Flores
leandro n. alem, buenos aires	Leandro N. Alem, Buenos Aires
lezama	Lezama
lincoln	Lincoln
lobería	Lobería
lobos	Lobos
lomas de zamora	Lomas de Zamora
luján	Luján
magdalena	Magdalena
maipú, buenos aires	Maipú, Buenos Aires
malvinas argentinas, buenos aires	Malvinas Argentinas, Buenos Aires
mar chiquita	Mar Chiquita
marcos paz	Marcos Paz
mercedes, buenos aires	Mercedes, Buenos Aires
merlo, buenos aires	Merlo, Buenos Aires
monte	Monte
monte hermoso	Monte Hermoso
moreno	Moreno
navarro	Navarro
necochea	Necochea
9 de julio, buenos aires	9 de Julio, Buenos Aires
olavarría	Olavarría
patagones	Patagones
pehuajó	Pehuajó
pellegrini	Pellegrini
pergamino	Pergamino
pila	Pila
pilar, buenos aires	Pilar, Buenos Aires
pinamar	Pinamar
presidente perón	Presidente Perón
puán	Puán
punta indio	Punta Indio
quilmes	Quilmes
ramallo	Ramallo
rauch	Rauch
rivadavia, buenos aires	Rivadavia, Buenos Aires
rojas	Rojas
roque pérez	Roque Pérez
saavedra	Saavedra
saladillo, buenos aires	Saladillo, Buenos Aires
salto	Salto
salliqueló	Salliqueló
san andrés de giles	San Andrés de Giles
san antonio de areco	San Antonio de Areco
san cayetano	San Cayetano
san fernando, buenos aires	San Fernando, Buenos Aires
san isidro, buenos aires	San Isidro, Buenos Aires
san miguel, buenos aires	San Miguel, Buenos Aires
san nicolás	San Nicolás
san pedro, buenos aires	San Pedro, Buenos Aires
san vicente, buenos aires	San Vicente, Buenos Aires
suipacha	Suipacha
tandil	Tandil
tapalqué	Tapalqué
tigre	Tigre
tordillo	Tordillo
tornquist	Tornquist
trenque lauquen	Trenque Lauquen
tres arroyos	Tres Arroyos
tres de febrero	Tres de Febrero
tres lomas	Tres Lomas
25 de mayo, buenos aires	25 de Mayo, Buenos Aires
vicente lópez	Vicente López
villa gesell	Villa Gesell
villarino	Villarino
zárate	Zárate
el rodeo, catamarca	El Rodeo, Catamarca
la puerta, catamarca	La Puerta, Catamarca
las juntas	Las Juntas
los varela	Los Varela
ancasti	Ancasti
aconquija	Aconquija
andalgalá	Andalgalá
antofagasta de la sierra	Antofagasta de la Sierra
belén	Belén
corral quemado	Corral Quemado
hualfín	Hualfín
londres	Londres
pozo de piedra	Pozo de Piedra
puerta de corral quemado	Puerta de Corral Quemado
puerta de san josé	Puerta de San José
san fernando, catamarca	San Fernando, Catamarca
villa vil	Villa Vil
capayán	Capayán
huillapima	Huillapima
san fernando del  valle de catamarca	San Fernando del  Valle de Catamarca
el alto	El Alto
tapso	Tapso
fray mamerto esquiú	Fray Mamerto Esquiú
icaño	Icaño
recreo, catamarca	Recreo, Catamarca
paclín	Paclín
mutquín	Mutquín
pomán	Pomán
saujil	Saujil
san josé, catamarca	San José, Catamarca
santa maría, catamarca	Santa María, Catamarca
los altos	Los Altos
santa rosa, catamarca	Santa Rosa, Catamarca
fiambalá	Fiambalá
tinogasta	Tinogasta
valle viejo	Valle Viejo
embalse	Embalse
la cruz, córdoba	La Cruz, Córdoba
los cóndores	Los Cóndores
río de los  sauces	Río de los  Sauces
santa rosa de calamuchita	Santa Rosa de Calamuchita
villa del  dique	Villa del  Dique
villa general belgrano	Villa General Belgrano
san agustín, córdoba	San Agustín, Córdoba
villa rumipal	Villa Rumipal
villa yacanto	Villa Yacanto
córdoba	Córdoba
agua de oro	Agua de Oro
colonia caroya	Colonia Caroya
colonia tirolesa	Colonia Tirolesa
estación juárez celman	Estación Juárez Celman
jesús maría	Jesús María
la calera, córdoba	La Calera, Córdoba
la granja	La Granja
malvinas argentinas, córdoba	Malvinas Argentinas, Córdoba
mendiolaza	Mendiolaza
río ceballos	Río Ceballos
saldán	Saldán
salsipuedes	Salsipuedes
unquillo	Unquillo
villa allende	Villa Allende
cruz del  eje	Cruz del  Eje
san marcos sierras	San Marcos Sierras
serrezuela	Serrezuela
villa de soto	Villa de Soto
buchardo	Buchardo
del campillo	Del Campillo
huinca renancó	Huinca Renancó
italó	Italó
jovita	Jovita
mattaldi	Mattaldi
villa huidobro	Villa Huidobro
villa valeria	Villa Valeria
arroyo cabral	Arroyo Cabral
ausonia	Ausonia
chazón	Chazón
etruria	Etruria
la laguna	La Laguna
la palestina	La Palestina
la playosa	La Playosa
luca	Luca
pasco	Pasco
silvio pellico	Silvio Pellico
ticino	Ticino
tío pujio	Tío Pujio
villa maría	Villa María
villa nueva	Villa Nueva
deán funes	Deán Funes
quilino	Quilino
alejandro roca	Alejandro Roca
bengolea	Bengolea
carnerillo	Carnerillo
charras	Charras
general cabrera	General Cabrera
general deheza	General Deheza
huanchilla	Huanchilla
la carlota	La Carlota
los cisnes	Los Cisnes
olaeta	Olaeta
reducción	Reducción
santa eufemia	Santa Eufemia
ucacha	Ucacha
alejo ledesma	Alejo Ledesma
arias	Arias
camilo aldao	Camilo Aldao
capitán general b. o'higgins	Capitán General B. O'Higgins
cavanagh	Cavanagh
colonia italiana	Colonia Italiana
corral de bustos	Corral de Bustos
cruz alta	Cruz Alta
general baldissera	General Baldissera
general roca	General Roca
guatimozín	Guatimozín
inriville	Inriville
isla verde	Isla Verde
leones	Leones
los surgentes	Los Surgentes
marcos juárez	Marcos Juárez
monte buey	Monte Buey
saira	Saira
san carlos minas	San Carlos Minas
salsacate	Salsacate
general levalle	General Levalle
la cesira	La Cesira
laboulaye	Laboulaye
melo	Melo
rosales	Rosales
serrano	Serrano
villa rossi	Villa Rossi
bialet massé	Bialet Massé
capilla del  monte	Capilla del  Monte
cosquín	Cosquín
huerta grande	Huerta Grande
la cumbre	La Cumbre
la falda	La Falda
los cocos	Los Cocos
san esteban	San Esteban
santa maría de punilla	Santa María de Punilla
tanti	Tanti
valle hermoso	Valle Hermoso
villa carlos paz	Villa Carlos Paz
villa giardino	Villa Giardino
achiras	Achiras
adelia maría	Adelia María
alcira	Alcira
alpa corral	Alpa Corral
berrotarán	Berrotarán
bulnes	Bulnes
chaján	Chaján
coronel baigorria	Coronel Baigorria
coronel moldes, córdoba	Coronel Moldes, Córdoba
elena	Elena
la cautiva	La Cautiva
las acequias	Las Acequias
las higueras	Las Higueras
las vertientes, córdoba	Las Vertientes, Córdoba
monte de los  gauchos	Monte de los  Gauchos
río cuarto	Río Cuarto
sampacho	Sampacho
san basilio	San Basilio
santa catalina, córdoba	Santa Catalina, Córdoba
tosquita	Tosquita
vicuña mackenna	Vicuña Mackenna
la para	La Para
la puerta, córdoba	La Puerta, Córdoba
monte cristo	Monte Cristo
obispo trejo	Obispo Trejo
piquillín	Piquillín
río primero	Río Primero
santa rosa de río primero	Santa Rosa de Río Primero
villa fontana	Villa Fontana
sebastián elcano	Sebastián Elcano
villa de maría	Villa de María
calchín	Calchín
calchín oeste	Calchín Oeste
capilla del  carmen	Capilla del  Carmen
carrilobo	Carrilobo
colazo	Colazo
costasacate	Costasacate
laguna larga	Laguna Larga
las junturas	Las Junturas
luque	Luque
manfredi	Manfredi
matorrales	Matorrales
oncativo	Oncativo
pilar, córdoba	Pilar, Córdoba
pozo del  molle	Pozo del  Molle
río segundo	Río Segundo
santiago temple	Santiago Temple
villa del  rosario	Villa del  Rosario
mina clavero	Mina Clavero
nono	Nono
san pedro, córdoba	San Pedro, Córdoba
villa cura brochero	Villa Cura Brochero
villa sarmiento (s. a.)	Villa Sarmiento (S. A.)
la paz, córdoba	La Paz, Córdoba
san javier y yacanto	San Javier y Yacanto
san josé, córdoba	San José, Córdoba
villa de las  rosas	Villa de las  Rosas
villa dolores	Villa Dolores
alicia	Alicia
altos de chipión	Altos de Chipión
arroyito	Arroyito
balnearia	Balnearia
brinkmann	Brinkmann
colonia marina	Colonia Marina
colonia prosperidad	Colonia Prosperidad
colonia san bartolomé	Colonia San Bartolomé
colonia vignaud	Colonia Vignaud
devoto	Devoto
el arañado	El Arañado
el fortín	El Fortín
el tío	El Tío
freyre	Freyre
la francia	La Francia
la paquita	La Paquita
la tordilla	La Tordilla
las varas	Las Varas
las varillas	Las Varillas
marull	Marull
miramar	Miramar
morteros	Morteros
porteña	Porteña
quebracho herrado	Quebracho Herrado
sacanta	Sacanta
san francisco, córdoba	San Francisco, Córdoba
saturnino maría laspiur	Saturnino María Laspiur
seeber	Seeber
tránsito	Tránsito
villa concepción del  tío	Villa Concepción del  Tío
alta gracia	Alta Gracia
despeñaderos	Despeñaderos
lozada	Lozada
malagueño	Malagueño
monte ralo	Monte Ralo
toledo	Toledo
san francisco del  chañar	San Francisco del  Chañar
almafuerte, córdoba	Almafuerte, Córdoba
colonia almada	Colonia Almada
corralito	Corralito
dalmacio vélez	Dalmacio Vélez
hernando	Hernando
james craik	James Craik
las perdices	Las Perdices
los zorros	Los Zorros
oliva	Oliva
pampayasta sud	Pampayasta Sud
río tercero	Río Tercero
tancacha	Tancacha
villa ascasubi	Villa Ascasubi
cañada de luque	Cañada de Luque
las peñas	Las Peñas
sarmiento, córdoba	Sarmiento, Córdoba
sinsacate	Sinsacate
villa del  totoral	Villa del  Totoral
las arrias	Las Arrias
lucio v. mansilla	Lucio V. Mansilla
san josé de la dormida	San José de la Dormida
san josé de las  salinas	San José de las  Salinas
san pedro norte	San Pedro Norte
villa tulumba	Villa Tulumba
alto alegre	Alto Alegre
ballesteros	Ballesteros
ballesteros sud	Ballesteros Sud
bell ville	Bell Ville
benjamín gould	Benjamín Gould
canals	Canals
chilibroste	Chilibroste
cintra	Cintra
colonia bismarck	Colonia Bismarck
idiazabal	Idiazabal
justiniano posse	Justiniano Posse
laborde	Laborde
monte leña	Monte Leña
monte maíz	Monte Maíz
morrison	Morrison
noetinger	Noetinger
ordóñez	Ordóñez
pascanas	Pascanas
pueblo italiano	Pueblo Italiano
san antonio de litín	San Antonio de Litín
san marcos sud	San Marcos Sud
viamonte	Viamonte
wenceslao escalante	Wenceslao Escalante
amboy	Amboy
calmayo	Calmayo
cañada del  sauce	Cañada del  Sauce
las bajadas	Las Bajadas
las caleras	Las Caleras
los molinos, córdoba	Los Molinos, Córdoba
los reartes	Los Reartes
lutti	Lutti
san ignacio, córdoba	San Ignacio, Córdoba
segunda usina	Segunda Usina
villa amancay	Villa Amancay
villa ciudad parque los  reartes	Villa Ciudad Parque los  Reartes
villa quillinzo	Villa Quillinzo
colonia vicente agüero	Colonia Vicente Agüero
el manzano	El Manzano
estación general paz	Estación General Paz
mi granja	Mi Granja
villa cerro azul	Villa Cerro Azul
alto de los  quebrachos	Alto de los  Quebrachos
bañado de soto	Bañado de Soto
cruz de caña	Cruz de Caña
el brete	El Brete
guanaco muerto	Guanaco Muerto
la batea	La Batea
la higuera	La Higuera
las cañadas	Las Cañadas
las playas	Las Playas
los chañaritos (c.d. eje)	Los Chañaritos (C.D. Eje)
media naranja	Media Naranja
paso viejo	Paso Viejo
tuclame	Tuclame
nicolás bruzzone	Nicolás Bruzzone
onagoity	Onagoity
pincen	Pincen
ranqueles, córdoba	Ranqueles, Córdoba
villa sarmiento (g.r.)	Villa Sarmiento (G.R.)
avellaneda, córdoba	Avellaneda, Córdoba
cañada de río pinto	Cañada de Río Pinto
chuña	Chuña
copacabana	Copacabana
los pozos	Los Pozos
olivares de san nicolás	Olivares de San Nicolás
villa gutiérrez	Villa Gutiérrez
assunta	Assunta
el rastreador	El Rastreador
pacheco de melo	Pacheco de Melo
paso del  durazno	Paso del  Durazno
colonia barge	Colonia Barge
saladillo, córdoba	Saladillo, Córdoba
villa elisa	Villa Elisa
ciénaga del  coro	Ciénaga del  Coro
el chacho	El Chacho
estancia de guadalupe	Estancia de Guadalupe
guasapampa	Guasapampa
la playa	La Playa
talaini	Talaini
tosno	Tosno
chancaní	Chancaní
las palmas, córdoba	Las Palmas, Córdoba
los talares	Los Talares
san gerónimo	San Gerónimo
tala cañada	Tala Cañada
villa de pocho	Villa de Pocho
leguizamón	Leguizamón
río bamba	Río Bamba
san joaquín	San Joaquín
cabalango	Cabalango
casa grande	Casa Grande
charbonier	Charbonier
cuesta blanca	Cuesta Blanca
estancia vieja	Estancia Vieja
mayu sumaj	Mayu Sumaj
san antonio de arredondo	San Antonio de Arredondo
san roque, córdoba	San Roque, Córdoba
tala huasi	Tala Huasi
villa parque siquiman	Villa Parque Siquiman
villa santa cruz del  lago	Villa Santa Cruz del  Lago
villa río icho cruz	Villa Río Icho Cruz
chucul	Chucul
"la carolina ""el potosi"""	"La Carolina ""El Potosi"""
las albahacas	Las Albahacas
las peñas sud	Las Peñas Sud
malena	Malena
suco	Suco
villa el chacay	Villa el Chacay
washington	Washington
atahona, córdoba	Atahona, Córdoba
cañada de machado	Cañada de Machado
capilla de los  remedios	Capilla de los  Remedios
chalacea	Chalacea
colonia las  cuatro esquinas	Colonia las  Cuatro Esquinas
comechingones	Comechingones
diego de rojas	Diego de Rojas
el crispín	El Crispín
esquina, córdoba	Esquina, Córdoba
kilómetro 658	Kilómetro 658
la posta	La Posta
la quinta	La Quinta
las gramillas	Las Gramillas
las saladas	Las Saladas
maquinista gallini	Maquinista Gallini
plaza de mercedes	Plaza de Mercedes
sagrada familia	Sagrada Familia
tinoco	Tinoco
cerro colorado	Cerro Colorado
chañar viejo	Chañar Viejo
eufrasio loza	Eufrasio Loza
gütemberg	Gütemberg
la rinconada	La Rinconada
los hoyos	Los Hoyos
puesto de castro	Puesto de Castro
rayo cortado	Rayo Cortado
santa elena	Santa Elena
villa candelaria norte	Villa Candelaria Norte
colonia videla	Colonia Videla
impira	Impira
los chañaritos	Los Chañaritos
rincón	Rincón
ambul	Ambul
arroyo los  patos	Arroyo los  Patos
las calles	Las Calles
las rabonas	Las Rabonas
panaholma	Panaholma
san lorenzo, córdoba	San Lorenzo, Córdoba
san vicente, córdoba	San Vicente, Córdoba
sauce arriba	Sauce Arriba
conlara	Conlara
la población	La Población
las tapias	Las Tapias
los cerrillos	Los Cerrillos
los hornillos	Los Hornillos
luyaba	Luyaba
colonia anita	Colonia Anita
colonia iturraspe, córdoba	Colonia Iturraspe, Córdoba
colonia las  pichanas	Colonia las  Pichanas
colonia san pedro	Colonia San Pedro
colonia valtelina	Colonia Valtelina
plaza luxardo	Plaza Luxardo
toro pujio	Toro Pujio
villa san esteban	Villa San Esteban
anisacate	Anisacate
bouwer	Bouwer
dique chico	Dique Chico
falda del  carmen	Falda del  Carmen
la cumbrecita	La Cumbrecita
la paisanita	La Paisanita
la rancherita	La Rancherita
la serranita	La Serranita
los cedros	Los Cedros
potrero de garay	Potrero de Garay
rafael garcía	Rafael García
san clemente	San Clemente
valle de anisacate	Valle de Anisacate
villa ciudad de américa	Villa Ciudad de América
villa del  prado	Villa del  Prado
villa la bolsa	Villa la Bolsa
villa los  aromos	Villa los  Aromos
villa parque santa ana	Villa Parque Santa Ana
villa san isidro	Villa San Isidro
caminiaga	Caminiaga
chuña huasi	Chuña Huasi
pozo nuevo	Pozo Nuevo
general fotheringham	General Fotheringham
las isletillas	Las Isletillas
pampayasta norte	Pampayasta Norte
punta del  agua	Punta del  Agua
candelaria sud	Candelaria Sud
capilla del  sitón	Capilla del  Sitón
la pampa	La Pampa
los mistoles	Los Mistoles
simbolar	Simbolar
churqui cañada	Churqui Cañada
el rodeo, córdoba	El Rodeo, Córdoba
rosario del  saladillo	Rosario del  Saladillo
aldea santa maría	Aldea Santa María
ana zumarán	Ana Zumarán
colonia bremen	Colonia Bremen
villa los  patos	Villa los  Patos
bella vista	Bella Vista
berón de astrada	Berón de Astrada
corrientes	Corrientes
riachuelo	Riachuelo
colonia santa rosa, corrientes	Colonia Santa Rosa, Corrientes
concepción	Concepción
tabay	Tabay
tatacuá	Tatacuá
curuzú cuatiá	Curuzú Cuatiá
perugorría	Perugorría
el sombrero	El Sombrero
esquina, corrientes	Esquina, Corrientes
pueblo libertador	Pueblo Libertador
alvear, corrientes	Alvear, Corrientes
estación torrent	Estación Torrent
caá catí	Caá Catí
itá ibaté	Itá Ibaté
lomas de vallejos	Lomas de Vallejos
palmar grande	Palmar Grande
carolina, corrientes	Carolina, Corrientes
goya	Goya
san isidro, corrientes	San Isidro, Corrientes
itatí	Itatí
ramada paso	Ramada Paso
colonia liebig's	Colonia Liebig'S
ituzaingó, corrientes	Ituzaingó, Corrientes
san antonio, corrientes	San Antonio, Corrientes
san carlos, corrientes	San Carlos, Corrientes
villa olivari	Villa Olivari
cruz de los  milagros	Cruz de los  Milagros
gobernador martínez	Gobernador Martínez
lavalle, corrientes	Lavalle, Corrientes
santa lucía	Santa Lucía
yataytí calle	Yataytí Calle
mburucuyá	Mburucuyá
felipe yofré	Felipe Yofré
mariano i. loza	Mariano I. Loza
mercedes, corrientes	Mercedes, Corrientes
colonia libertad	Colonia Libertad
juan pujol	Juan Pujol
mocoretá	Mocoretá
monte caseros	Monte Caseros
bonpland, corrientes	Bonpland, Corrientes
parada pucheta	Parada Pucheta
paso de los  libres	Paso de los  Libres
tapebicuá	Tapebicuá
saladas	Saladas
san lorenzo, corrientes	San Lorenzo, Corrientes
paso de la patria	Paso de la Patria
san cosme	San Cosme
santa ana, corrientes	Santa Ana, Corrientes
herlitzka	Herlitzka
san luis del  palmar	San Luis del  Palmar
colonia carlos pellegrini	Colonia Carlos Pellegrini
guaviraví	Guaviraví
la cruz, corrientes	La Cruz, Corrientes
yapeyú	Yapeyú
loreto, corrientes	Loreto, Corrientes
san miguel, corrientes	San Miguel, Corrientes
9 de julio, corrientes	9 de Julio, Corrientes
pedro r. fernández	Pedro R. Fernández
chavarría	Chavarría
san roque, corrientes	San Roque, Corrientes
garruchos	Garruchos
gobernador ing. valentín virasoro	Gobernador Ing. Valentín Virasoro
jose rafael gomez	Jose Rafael Gomez
santo tomé, corrientes	Santo Tomé, Corrientes
sauce	Sauce
concepción del  bermejo	Concepción del  Bermejo
los frentones	Los Frentones
pampa del  infierno	Pampa del  Infierno
taco pozo	Taco Pozo
general vedia	General Vedia
isla del  cerrito	Isla del  Cerrito
la leonesa	La Leonesa
las palmas, chaco	Las Palmas, Chaco
puerto bermejo	Puerto Bermejo
puerto eva perón	Puerto Eva Perón
presidencia roque sáenz peña	Presidencia Roque Sáenz Peña
charata	Charata
gancedo	Gancedo
general capdevila	General Capdevila
general pinedo	General Pinedo
hermoso campo	Hermoso Campo
corzuela	Corzuela
chorotis	Chorotis
santa sylvina	Santa Sylvina
la escondida	La Escondida
lapachito	Lapachito
la verde	La Verde
makallé	Makallé
el sauzalito	El Sauzalito
misión nueva pompeya	Misión Nueva Pompeya
fuerte esperanza	Fuerte Esperanza
juan josé castelli	Juan José Castelli
miraflores	Miraflores
villa río bermejito	Villa Río Bermejito
avia terai	Avia Terai
campo largo	Campo Largo
napenay	Napenay
colonia popular	Colonia Popular
laguna blanca, chaco	Laguna Blanca, Chaco
ciervo petiso	Ciervo Petiso
puerto tirol	Puerto Tirol
general san martín, chaco	General San Martín, Chaco
la eduvigis	La Eduvigis
laguna limpia	Laguna Limpia
pampa almirón	Pampa Almirón
pampa del  indio	Pampa del  Indio
presidencia roca	Presidencia Roca
tres isletas	Tres Isletas
coronel du graty	Coronel Du Graty
enrique urien	Enrique Urien
villa ángela	Villa Ángela
las breñas	Las Breñas
la clotilde	La Clotilde
la tigra	La Tigra
san bernardo, chaco	San Bernardo, Chaco
presidencia de la plaza	Presidencia de la Plaza
colonia benitez	Colonia Benitez
quitilipi	Quitilipi
barranqueras	Barranqueras
basail	Basail
fontana	Fontana
puerto vilelas	Puerto Vilelas
resistencia	Resistencia
samuhú	Samuhú
villa berthet	Villa Berthet
capitán solari	Capitán Solari
colonias elisa	Colonias Elisa
colonias unidas	Colonias Unidas
las garcitas	Las Garcitas
cote lai	Cote Lai
charadai	Charadai
machagai	Machagai
puerto madryn	Puerto Madryn
cholila	Cholila
el hoyo	El Hoyo
el maitén	El Maitén
epuyén	Epuyén
lago puelo	Lago Puelo
comodoro rivadavia	Comodoro Rivadavia
rada tilly	Rada Tilly
camarones	Camarones
corcovado	Corcovado
esquel	Esquel
trevelín	Trevelín
dolavon	Dolavon
gaiman	Gaiman
tecka	Tecka
rawson	Rawson
trelew	Trelew
alto río senguer	Alto Río Senguer
río mayo	Río Mayo
sarmiento, chubut	Sarmiento, Chubut
gobernador costa	Gobernador Costa
josé de san martín	José de San Martín
río pico	Río Pico
gualjaina	Gualjaina
28 de julio	28 de Julio
paso de indios	Paso de Indios
puerto pirámides	Puerto Pirámides
cushamen	Cushamen
cerro centinela	Cerro Centinela
dique florentino ameghino	Dique Florentino Ameghino
gastre	Gastre
lagunita salada	Lagunita Salada
aldea epulef	Aldea Epulef
carrenleufú	Carrenleufú
colan conhué	Colan Conhué
paso del  sapo	Paso del  Sapo
las plumas	Las Plumas
los altares	Los Altares
aldea beleiro	Aldea Beleiro
doctor ricardo rojas	Doctor Ricardo Rojas
facundo	Facundo
lago blanco	Lago Blanco
buen pasto	Buen Pasto
gan gan	Gan Gan
telsen	Telsen
dr. atilio oscar viglione	Dr. Atilio Oscar Viglione
laguna yema	Laguna Yema
formosa	Formosa
general lucio victorio mansilla	General Lucio Victorio Mansilla
herradura	Herradura
misión san francisco de laishí	Misión San Francisco de Laishí
villa escolar	Villa Escolar
ingeniero guillermo n. juárez	Ingeniero Guillermo N. Juárez
comandante fontana	Comandante Fontana
estanislao del campo	Estanislao del Campo
general belgrano, formosa	General Belgrano, Formosa
general güemes, formosa	General Güemes, Formosa
ibarreta	Ibarreta
las lomitas	Las Lomitas
pozo del tigre	Pozo del Tigre
san martín dos	San Martín Dos
espinillo	Espinillo
laguna blanca, formosa	Laguna Blanca, Formosa
misión taacaglé	Misión Taacaglé
clorinda	Clorinda
laguna naik neck	Laguna Naik Neck
riacho he-he	Riacho He-He
el colorado	El Colorado
mayor vicente e. villafañe	Mayor Vicente E. Villafañe
palo santo	Palo Santo
pirané	Pirané
villa dos trece	Villa Dos Trece
general mosconi, formosa	General Mosconi, Formosa
los chiriguanos	Los Chiriguanos
colonia pastoril	Colonia Pastoril
gran guardia	Gran Guardia
san hilario	San Hilario
fortín lugones	Fortín Lugones
subteniente perín	Subteniente Perín
buena vista, formosa	Buena Vista, Formosa
tres lagunas	Tres Lagunas
siete palmas	Siete Palmas
portón negro	Portón Negro
abra pampa	Abra Pampa
san salvador de jujuy	San Salvador de Jujuy
el carmen	El Carmen
monterrico	Monterrico
perico	Perico
el aguilar	El Aguilar
humahuaca	Humahuaca
caimancito	Caimancito
calilegua	Calilegua
fraile pintado	Fraile Pintado
libertador general san martín	Libertador General San Martín
yuto	Yuto
palpalá	Palpalá
la esperanza, jujuy	La Esperanza, Jujuy
la mendieta	La Mendieta
san pedro de jujuy	San Pedro de Jujuy
el talar	El Talar
palma sola	Palma Sola
santa clara	Santa Clara
tilcara	Tilcara
la quiaca	La Quiaca
abdón castro tolay	Abdón Castro Tolay
abralaite	Abralaite
puesto del  marqués	Puesto del  Marqués
yala	Yala
aguas calientes	Aguas Calientes
pampa blanca	Pampa Blanca
puesto viejo	Puesto Viejo
hipólito yrigoyen, jujuy	Hipólito Yrigoyen, Jujuy
tres cruces	Tres Cruces
mina pirquitas	Mina Pirquitas
rinconada	Rinconada
san antonio, jujuy	San Antonio, Jujuy
arrayanal	Arrayanal
el fuerte	El Fuerte
rodeíto	Rodeíto
rosario de río grande	Rosario de Río Grande
el piquete	El Piquete
vinalito	Vinalito
cieneguillas	Cieneguillas
cusi cusi	Cusi Cusi
santa catalina, jujuy	Santa Catalina, Jujuy
catua	Catua
coranzuli	Coranzuli
susques	Susques
huacalera	Huacalera
maimará	Maimará
purmamarca	Purmamarca
tumbaya	Tumbaya
volcán	Volcán
caspalá	Caspalá
pampichuela	Pampichuela
san francisco, jujuy	San Francisco, Jujuy
santa ana, jujuy	Santa Ana, Jujuy
valle grande	Valle Grande
barrios	Barrios
cangrejillos	Cangrejillos
el cóndor	El Cóndor
pumahuasi	Pumahuasi
yavi	Yavi
abramo	Abramo
algarrobo del  águila	Algarrobo del  Águila
alpachiri	Alpachiri
alta italia	Alta Italia
anguil	Anguil
arata	Arata
ataliva roca	Ataliva Roca
bernardo larroude	Bernardo Larroude
bernasconi	Bernasconi
caleufú	Caleufú
carro quemado	Carro Quemado
catriló	Catriló
ceballos	Ceballos
colonia barón	Colonia Barón
conhelo	Conhelo
coronel hilario lagos	Coronel Hilario Lagos
doblas	Doblas
dorila	Dorila
eduardo castex	Eduardo Castex
embajador martini	Embajador Martini
general acha	General Acha
general campos	General Campos
general pico	General Pico
general san martín, la pampa	General San Martín, La Pampa
guatraché	Guatraché
ingeniero luiggi	Ingeniero Luiggi
intendente alvear	Intendente Alvear
jacinto arauz	Jacinto Arauz
la adela	La Adela
la humada	La Humada
la maruja	La Maruja
lonquimay	Lonquimay
luan toro	Luan Toro
macachín	Macachín
mauricio mayer	Mauricio Mayer
metileo	Metileo
miguel cané	Miguel Cané
miguel riglos	Miguel Riglos
monte nievas	Monte Nievas
parera	Parera
puelches	Puelches
puelén	Puelén
quehué	Quehué
quemú quemú	Quemú Quemú
rancul	Rancul
realicó	Realicó
rolón	Rolón
santa isabel, la pampa	Santa Isabel, La Pampa
santa rosa, la pampa	Santa Rosa, La Pampa
santa teresa, la pampa	Santa Teresa, La Pampa
telén	Telén
toay	Toay
tomás manuel anchorena	Tomás Manuel Anchorena
trenel	Trenel
uriburu	Uriburu
veinticinco de mayo	Veinticinco de Mayo
vértiz	Vértiz
victorica	Victorica
villa mirasol	Villa Mirasol
winifreda	Winifreda
casa de piedra	Casa de Piedra
adolfo van praet	Adolfo Van Praet
agustoni	Agustoni
colonia santa maría	Colonia Santa María
cuchillo có	Cuchillo Có
chacharramendi	Chacharramendi
falucho	Falucho
gobernador duval	Gobernador Duval
la reforma	La Reforma
limay mahuida	Limay Mahuida
loventué	Loventué
maisonnave	Maisonnave
perú	Perú
pichi huinca	Pichi Huinca
quetrequén	Quetrequén
relmo	Relmo
rucanelo	Rucanelo
sarah	Sarah
speluzzi	Speluzzi
unanue	Unanue
arauco	Arauco
capital, la rioja	Capital, La Rioja
castro barros	Castro Barros
coronel felipe varela	Coronel Felipe Varela
chamical	Chamical
chilecito	Chilecito
famatina	Famatina
general ángel vicente peñaloza	General Ángel Vicente Peñaloza
general belgrano, la rioja	General Belgrano, La Rioja
general juan facundo quiroga	General Juan Facundo Quiroga
general lamadrid	General Lamadrid
general ocampo	General Ocampo
general san martín, la rioja	General San Martín, La Rioja
vinchina	Vinchina
independencia	Independencia
rosario vera peñaloza	Rosario Vera Peñaloza
san blas de los  sauces	San Blas de los  Sauces
sanagasta	Sanagasta
capital, mendoza	Capital, Mendoza
general alvear, mendoza	General Alvear, Mendoza
godoy cruz	Godoy Cruz
guaymallén	Guaymallén
junín, mendoza	Junín, Mendoza
la paz, mendoza	La Paz, Mendoza
las heras	Las Heras
lavalle, mendoza	Lavalle, Mendoza
luján de cuyo	Luján de Cuyo
maipú, mendoza	Maipú, Mendoza
malargüe	Malargüe
rivadavia, mendoza	Rivadavia, Mendoza
san carlos, mendoza	San Carlos, Mendoza
san martín, mendoza	San Martín, Mendoza
san rafael	San Rafael
santa rosa, mendoza	Santa Rosa, Mendoza
tunuyán	Tunuyán
tupungato	Tupungato
apóstoles	Apóstoles
azara	Azara
san josé, misiones	San José, Misiones
tres capones	Tres Capones
aristóbulo del valle	Aristóbulo del Valle
campo grande, misiones	Campo Grande, Misiones
dos de mayo	Dos de Mayo
bonpland, misiones	Bonpland, Misiones
candelaria, misiones	Candelaria, Misiones
cerro corá	Cerro Corá
loreto, misiones	Loreto, Misiones
mártires	Mártires
profundidad	Profundidad
santa ana, misiones	Santa Ana, Misiones
fachinal	Fachinal
garupá	Garupá
posadas	Posadas
concepción de la sierra	Concepción de la Sierra
santa maría, misiones	Santa María, Misiones
colonia delicia	Colonia Delicia
colonia victoria	Colonia Victoria
eldorado	Eldorado
9 de julio, misiones	9 de Julio, Misiones
santiago de liniers	Santiago de Liniers
bernardo de irigoyen, misiones	Bernardo de Irigoyen, Misiones
comandante a. guacurary	Comandante A. Guacurary
san antonio, misiones	San Antonio, Misiones
el soberbio	El Soberbio
san vicente, misiones	San Vicente, Misiones
puerto esperanza	Puerto Esperanza
iguazú	Iguazú
libertad	Libertad
colonia wanda	Colonia Wanda
almafuerte, misiones	Almafuerte, Misiones
arroyo del medio	Arroyo del Medio
caa yarí	Caa Yarí
cerro azul	Cerro Azul
dos arroyos	Dos Arroyos
gobernador lópez	Gobernador López
leandro n. alem, misiones	Leandro N. Alem, Misiones
olegario v. andrade	Olegario V. Andrade
capioví	Capioví
el alcázar	El Alcázar
garuhapé	Garuhapé
leoni	Leoni
puerto rico	Puerto Rico
ruiz de montoya	Ruiz de Montoya
caraguatay	Caraguatay
montecarlo	Montecarlo
puerto piray	Puerto Piray
campo ramón	Campo Ramón
campo viera	Campo Viera
colonia alberdi	Colonia Alberdi
gral. alvear	Gral. Alvear
guaraní	Guaraní
los helechos	Los Helechos
oberá	Oberá
panambí	Panambí
san martín, misiones	San Martín, Misiones
colonia polana	Colonia Polana
corpus	Corpus
general j. j. urquiza	General J. J. Urquiza
gobernador roca	Gobernador Roca
hipólito irigoyen	Hipólito Irigoyen
jardín américa	Jardín América
san ignacio, misiones	San Ignacio, Misiones
santo pipo	Santo Pipo
ameghino	Ameghino
itacaruaré	Itacaruaré
mojón grande	Mojón Grande
san javier, misiones	San Javier, Misiones
san pedro, misiones	San Pedro, Misiones
alba posse	Alba Posse
colonia aurora	Colonia Aurora
25 de mayo, misiones	25 de Mayo, Misiones
villa lago meliquina	Villa Lago Meliquina
aluminé	Aluminé
añelo	Añelo
san patricio del  chañar	San Patricio del  Chañar
las coloradas	Las Coloradas
piedra del  águila	Piedra del  Águila
centenario	Centenario
cutral có	Cutral Có
neuquén	Neuquén
plaza huincul	Plaza Huincul
plottier	Plottier
senillosa	Senillosa
villa el chocón	Villa el Chocón
vista alegre	Vista Alegre
chos malal	Chos Malal
tricao malal	Tricao Malal
junín de los  andes	Junín de los  Andes
san martín de los  andes	San Martín de los  Andes
loncopué	Loncopué
villa la angostura	Villa la Angostura
andacollo	Andacollo
huinganco	Huinganco
las ovejas	Las Ovejas
los miches	Los Miches
caviahue-copahue	Caviahue-Copahue
el cholar	El Cholar
el huecú	El Huecú
taquimilán	Taquimilán
barrancas, neuquén	Barrancas, Neuquén
buta ranquil	Buta Ranquil
rincón de los  sauces	Rincón de los  Sauces
picún leufú	Picún Leufú
bajada del  agrio	Bajada del  Agrio
las lajas	Las Lajas
mariano moreno	Mariano Moreno
zapala	Zapala
villa pehuenia	Villa Pehuenia
aguada san roque	Aguada San Roque
los chihuidos	Los Chihuidos
pilo lil	Pilo Lil
santo tomás	Santo Tomás
sauzal bonito	Sauzal Bonito
coyuco-cochico	Coyuco-Cochico
villa curi leuvú	Villa Curi Leuvú
chorriaca	Chorriaca
villa traful	Villa Traful
guañacos	Guañacos
manzano amargo	Manzano Amargo
varvarco - invernada vieja	Varvarco - Invernada Vieja
villa del  nahueve	Villa del  Nahueve
octavio pico	Octavio Pico
el sauce	El Sauce
paso aguerre	Paso Aguerre
quili malal	Quili Malal
covunco abajo	Covunco Abajo
los catutos	Los Catutos
ramón castro	Ramón Castro
villa del  puente picún leufú	Villa del  Puente Picún Leufú
guardia mitre	Guardia Mitre
viedma	Viedma
chimpay	Chimpay
choele choel	Choele Choel
coronel belisle	Coronel Belisle
darwin	Darwin
lamarque	Lamarque
luis beltran	Luis Beltran
pomona	Pomona
el bolson	El Bolson
san carlos de bariloche	San Carlos de Bariloche
gral. conesa	Gral. Conesa
allen	Allen
campo grande, río negro	Campo Grande, Río Negro
catriel	Catriel
cervantes	Cervantes
chichinales	Chichinales
cinco saltos	Cinco Saltos
cipolletti	Cipolletti
c. cordero	C. Cordero
gral. enrique godoy	Gral. Enrique Godoy
gral. fdez. oro	Gral. Fdez. Oro
gral. roca	Gral. Roca
ingeniero huergo	Ingeniero Huergo
mainque	Mainque
villa regina	Villa Regina
ministro ramos mexia	Ministro Ramos Mexia
sierra colorada	Sierra Colorada
ñorquinco	Ñorquinco
rio colorado, río negro	Rio Colorado, Río Negro
comallo	Comallo
pilcaniyeu	Pilcaniyeu
san antonio oeste	San Antonio Oeste
sierra grande	Sierra Grande
valcheta	Valcheta
ing. jacobacci	Ing. Jacobacci
los menucos	Los Menucos
maquinchao	Maquinchao
dina huapi	Dina Huapi
apolinario saravia	Apolinario Saravia
el quebrachal	El Quebrachal
general pizarro	General Pizarro
joaquín v. gonzález	Joaquín V. González
cachi	Cachi
payogasta	Payogasta
cafayate	Cafayate
salta	Salta
san lorenzo, salta	San Lorenzo, Salta
cerrillos	Cerrillos
la merced	La Merced
chicoana	Chicoana
el carril	El Carril
campo santo	Campo Santo
el bordo	El Bordo
general güemes, salta	General Güemes, Salta
aguaray	Aguaray
embarcación	Embarcación
ballivián	Ballivián
general mosconi, salta	General Mosconi, Salta
profesor salvador mazza	Profesor Salvador Mazza
tartagal, salta	Tartagal, Salta
guachipas	Guachipas
iruya	Iruya
isla de cañas	Isla de Cañas
la caldera	La Caldera
vaqueros	Vaqueros
el jardín	El Jardín
el tala	El Tala
la candelaria	La Candelaria
la poma	La Poma
coronel moldes, salta	Coronel Moldes, Salta
la viña	La Viña
san antonio de los  cobres	San Antonio de los  Cobres
tolar grande	Tolar Grande
el galpón	El Galpón
molinos	Molinos
río piedras	Río Piedras
seclantás	Seclantás
colonia santa rosa, salta	Colonia Santa Rosa, Salta
hipólito yrigoyen, salta	Hipólito Yrigoyen, Salta
pichanal	Pichanal
san ramón de la nueva orán	San Ramón de la Nueva Orán
urundel	Urundel
rivadavia banda norte	Rivadavia Banda Norte
rivadavia banda sur	Rivadavia Banda Sur
santa victoria este	Santa Victoria Este
el potrero	El Potrero
rosario de la frontera	Rosario de la Frontera
campo quijano	Campo Quijano
rosario de lerma	Rosario de Lerma
angastaco	Angastaco
animaná	Animaná
san carlos, salta	San Carlos, Salta
los toldos	Los Toldos
nazareno	Nazareno
santa victoria oeste	Santa Victoria Oeste
candelaria, san luis	Candelaria, San Luis
lujan	Lujan
quines	Quines
san francisco, san luis	San Francisco, San Luis
v. gral. roca	V. Gral. Roca
estancia grande	Estancia Grande
la toma	La Toma
concaran	Concaran
naschel	Naschel
tilisarao	Tilisarao
justo daract	Justo Daract
ranqueles, san luis	Ranqueles, San Luis
villa mercedes	Villa Mercedes
buena esperanza	Buena Esperanza
union	Union
sta rosa del  conlara	Sta Rosa del  Conlara
merlo, san luis	Merlo, San Luis
desaguadero	Desaguadero
juana koslay	Juana Koslay
san luis	San Luis
san martin	San Martin
leandro n. alem, san luis	Leandro N. Alem, San Luis
la calera, san luis	La Calera, San Luis
nogoli	Nogoli
v. de la quebrada	V. de la Quebrada
carolina, san luis	Carolina, San Luis
el trapiche	El Trapiche
fraga	Fraga
saladillo, san luis	Saladillo, San Luis
cortaderas	Cortaderas
papagayos	Papagayos
renca	Renca
san pablo	San Pablo
villa del  carmen	Villa del  Carmen
villa larca	Villa Larca
san jose del  morro	San Jose del  Morro
juan llerena	Juan Llerena
la punilla	La Punilla
lavaisse	Lavaisse
anchorena	Anchorena
arizona	Arizona
bagual	Bagual
batavia	Batavia
navia	Navia
nueva galia	Nueva Galia
carpinteria	Carpinteria
lafinur	Lafinur
los molles	Los Molles
talita	Talita
alto pelado	Alto Pelado
alto pencoso	Alto Pencoso
balde	Balde
beazley	Beazley
el volcan	El Volcan
p. de los  funes	P. de los  Funes
san jeronimo	San Jeronimo
zanjitas	Zanjitas
las vertientes, san luis	Las Vertientes, San Luis
las aguadas	Las Aguadas
las chacras	Las Chacras
las lagunas	Las Lagunas
paso grande	Paso Grande
v. de praga	V. de Praga
la punta	La Punta
juan jorba	Juan Jorba
fortin el patria	Fortin el Patria
fortuna	Fortuna
los cajones	Los Cajones
armstrong	Armstrong
las parejas	Las Parejas
las rosas	Las Rosas
casilda	Casilda
frontera	Frontera
rafaela	Rafaela
sunchales	Sunchales
villa constitución	Villa Constitución
firmat	Firmat
rufino	Rufino
villa cañás	Villa Cañás
avellaneda, santa fe	Avellaneda, Santa Fe
las toscas	Las Toscas
malabrigo	Malabrigo
reconquista	Reconquista
cañada de gómez	Cañada de Gómez
totoras	Totoras
laguna paiva	Laguna Paiva
recreo, santa fe	Recreo, Santa Fe
santa fe	Santa Fe
santo tomé, santa fe	Santo Tomé, Santa Fe
esperanza	Esperanza
san carlos centro	San Carlos Centro
tostado	Tostado
arroyo seco	Arroyo Seco
funes	Funes
granadero baigorria	Granadero Baigorria
pérez	Pérez
villa gobernador gálvez	Villa Gobernador Gálvez
ceres	Ceres
san cristóbal	San Cristóbal
san javier, santa fe	San Javier, Santa Fe
coronda	Coronda
gálvez	Gálvez
san genaro	San Genaro
capitán bermúdez	Capitán Bermúdez
carcarañá	Carcarañá
venado tuerto	Venado Tuerto
fray luis beltrán	Fray Luis Beltrán
roldán	Roldán
san lorenzo, santa fe	San Lorenzo, Santa Fe
el trébol	El Trébol
san jorge	San Jorge
sastre	Sastre
calchaquí	Calchaquí
vera	Vera
villa ocampo	Villa Ocampo
bouquet	Bouquet
montes de oca	Montes de Oca
tortugas	Tortugas
arequito	Arequito
arteaga	Arteaga
berabevú	Berabevú
bigand	Bigand
chañar ladeado	Chañar Ladeado
gödeken	Gödeken
los molinos, santa fe	Los Molinos, Santa Fe
los quirquinchos	Los Quirquinchos
san josé de la esquina	San José de la Esquina
sanford	Sanford
rosario	Rosario
villada	Villada
angélica	Angélica
ataliva	Ataliva
aurelia	Aurelia
bauer y sigel	Bauer y Sigel
bella italia	Bella Italia
colonia bicha	Colonia Bicha
castellanos	Castellanos
colonia cello	Colonia Cello
colonia iturraspe, santa fe	Colonia Iturraspe, Santa Fe
colonia raquel	Colonia Raquel
coronel fraga	Coronel Fraga
egusquiza	Egusquiza
esmeralda	Esmeralda
estación clucellas	Estación Clucellas
eusebia y carolina	Eusebia y Carolina
eustolia	Eustolia
fidela	Fidela
galisteo	Galisteo
garibaldi	Garibaldi
hugentobler	Hugentobler
humberto primo	Humberto Primo
josefina	Josefina
lehmann	Lehmann
maría juana	María Juana
maua	Maua
plaza clucellas	Plaza Clucellas
presidente roca	Presidente Roca
pueblo marini	Pueblo Marini
ramona	Ramona
saguier	Saguier
san antonio, santa fe	San Antonio, Santa Fe
san vicente, santa fe	San Vicente, Santa Fe
santa clara de saguier	Santa Clara de Saguier
susana	Susana
tacural	Tacural
tacurales	Tacurales
vila	Vila
villa san josé	Villa San José
virginia	Virginia
zenón pereyra	Zenón Pereyra
alcorta	Alcorta
bombal	Bombal
cañada rica	Cañada Rica
cepeda	Cepeda
empalme villa constitución	Empalme Villa Constitución
general gelly	General Gelly
godoy	Godoy
juan bernabé molina	Juan Bernabé Molina
juncal	Juncal
la vanguardia	La Vanguardia
m9ximo paz	M9Ximo Paz
pavón	Pavón
pavón arriba	Pavón Arriba
peyrano	Peyrano
rueda	Rueda
santa teresa, santa fe	Santa Teresa, Santa Fe
sargento cabral	Sargento Cabral
theobald	Theobald
cayastá	Cayastá
colonia mascias	Colonia Mascias
helvecia	Helvecia
saladero mariano cabal	Saladero Mariano Cabal
santa rosa de calchines	Santa Rosa de Calchines
aarón castellanos	Aarón Castellanos
amenábar	Amenábar
cafferata	Cafferata
cañada del  ucle	Cañada del  Ucle
carmen	Carmen
carreras	Carreras
chapuy	Chapuy
chovet	Chovet
christophersen	Christophersen
diego de alvear	Diego de Alvear
elortondo	Elortondo
hughes	Hughes
la chispa	La Chispa
labordeboy	Labordeboy
lazzarino	Lazzarino
maggiolo	Maggiolo
maría teresa	María Teresa
melincué	Melincué
miguel torres	Miguel Torres
murphy	Murphy
san eduardo	San Eduardo
san francisco de santa fe	San Francisco de Santa Fe
san gregorio	San Gregorio
sancti spiritu	Sancti Spiritu
santa isabel, santa fe	Santa Isabel, Santa Fe
teodelina	Teodelina
wheelwright	Wheelwright
arroyo ceibal	Arroyo Ceibal
berna	Berna
el arazá	El Arazá
el rabón	El Rabón
el sombrerito	El Sombrerito
florencia	Florencia
guadalupe norte	Guadalupe Norte
ingeniero chanourdie	Ingeniero Chanourdie
la sarita	La Sarita
lanteri	Lanteri
las garzas	Las Garzas
los laureles	Los Laureles
nicanor molinas	Nicanor Molinas
san antonio de obligado	San Antonio de Obligado
tacuarendí	Tacuarendí
villa ana	Villa Ana
puerto general san martín	Puerto General San Martín
villa guillermina	Villa Guillermina
bustinza	Bustinza
carrizales	Carrizales
clason	Clason
correa	Correa
lucio v. lópez	Lucio V. López
oliveros	Oliveros
pueblo andino	Pueblo Andino
salto grande	Salto Grande
serodino	Serodino
villa eloísa	Villa Eloísa
arroyo aguiar	Arroyo Aguiar
arroyo leyes	Arroyo Leyes
cabal	Cabal
campo andino	Campo Andino
candioti	Candioti
emilia	Emilia
llambi campbell	Llambi Campbell
monte vera	Monte Vera
nelson	Nelson
san josé del  rincón	San José del  Rincón
sauce viejo	Sauce Viejo
cavour	Cavour
colonia san josé	Colonia San José
cululú	Cululú
elisa	Elisa
empalme san carlos	Empalme San Carlos
felicia	Felicia
franck	Franck
grutly	Grutly
hipatía	Hipatía
humboldt	Humboldt
ituzaingó, santa fe	Ituzaingó, Santa Fe
jacinto l. arauz	Jacinto L. Arauz
la pelada	La Pelada
las tunas	Las Tunas
maría luisa	María Luisa
matilde	Matilde
nuevo torino	Nuevo Torino
pilar, santa fe	Pilar, Santa Fe
progreso	Progreso
providencia	Providencia
pujato norte	Pujato Norte
rivadavia, santa fe	Rivadavia, Santa Fe
sa pereyra	Sa Pereyra
san agustín, santa fe	San Agustín, Santa Fe
san carlos norte	San Carlos Norte
san carlos sud	San Carlos Sud
san jerónimo del  sauce	San Jerónimo del  Sauce
san jerónimo norte	San Jerónimo Norte
san mariano	San Mariano
santa clara de buena vista	Santa Clara de Buena Vista
santa maría centro	Santa María Centro
santa maría norte	Santa María Norte
santo domingo	Santo Domingo
sarmiento, santa fe	Sarmiento, Santa Fe
soutomayor	Soutomayor
esteban rams	Esteban Rams
gato colorado	Gato Colorado
gregoria pérez de denis	Gregoria Pérez de Denis
juan de garay	Juan de Garay
logroño	Logroño
montefiore	Montefiore
pozo borrado	Pozo Borrado
san bernardo, santa fe	San Bernardo, Santa Fe
santa margarita	Santa Margarita
villa minetti	Villa Minetti
acebal	Acebal
albarellos	Albarellos
álvarez	Álvarez
alvear, santa fe	Alvear, Santa Fe
arminda	Arminda
carmen del  sauce	Carmen del  Sauce
coronel bogado	Coronel Bogado
fighiera	Fighiera
general lagos	General Lagos
ibarlucea	Ibarlucea
piñero	Piñero
pueblo esther	Pueblo Esther
pueblo muñoz	Pueblo Muñoz
soldini	Soldini
uranga	Uranga
villa amelia	Villa Amelia
zavalla	Zavalla
coronel domínguez	Coronel Domínguez
aguará grande	Aguará Grande
ambrosetti	Ambrosetti
arrufo	Arrufo
capivara	Capivara
colonia ana	Colonia Ana
colonia bossi	Colonia Bossi
colonia rosa	Colonia Rosa
constanza	Constanza
curupaity	Curupaity
dos rosas y la legua	Dos Rosas y la Legua
hersilia	Hersilia
huanqueros	Huanqueros
la cabral	La Cabral
colonia la clara	Colonia la Clara
la lucila	La Lucila
la rubia	La Rubia
las avispas	Las Avispas
las palmeras	Las Palmeras
moisés ville	Moisés Ville
monigotes	Monigotes
monte oscuridad	Monte Oscuridad
ñanducita	Ñanducita
palacios	Palacios
portugalete	Portugalete
san guillermo	San Guillermo
santurce	Santurce
soledad	Soledad
suardi	Suardi
villa saralegui	Villa Saralegui
villa trinidad	Villa Trinidad
alejandra	Alejandra
cacique ariacaiquín	Cacique Ariacaiquín
colonia durán	Colonia Durán
la brava	La Brava
romang	Romang
arocena	Arocena
barrancas, santa fe	Barrancas, Santa Fe
bernardo de irigoyen, santa fe	Bernardo de Irigoyen, Santa Fe
campo piaggio	Campo Piaggio
casalegno	Casalegno
centeno	Centeno
desvío arijón	Desvío Arijón
díaz	Díaz
gaboto	Gaboto
gessler	Gessler
pueblo irigoyen	Pueblo Irigoyen
larrechea	Larrechea
loma alta	Loma Alta
maciel	Maciel
monje	Monje
san eugenio	San Eugenio
san fabián	San Fabián
angeloni	Angeloni
cayastacito	Cayastacito
colonia dolores	Colonia Dolores
esther	Esther
gobernador crespo	Gobernador Crespo
la camila	La Camila
la criolla	La Criolla
la penca y caraguatá	La Penca y Caraguatá
marcelino escalada	Marcelino Escalada
naré	Naré
pedro gómez cello	Pedro Gómez Cello
ramayón	Ramayón
san mart, santa fe	San Mart, Santa Fe
silva	Silva
vera y pintado	Vera y Pintado
videla	Videla
aldao	Aldao
coronel arnold	Coronel Arnold
fuentes	Fuentes
luis palacios	Luis Palacios
pujato	Pujato
ricardone	Ricardone
san jerónimo sud	San Jerónimo Sud
timbúes	Timbúes
villa mugueta	Villa Mugueta
cañada rosquín	Cañada Rosquín
carlos pellegrini	Carlos Pellegrini
casas	Casas
castelar	Castelar
colonia belgrano	Colonia Belgrano
crispi	Crispi
landeta	Landeta
las bandurrias	Las Bandurrias
las petacas	Las Petacas
los cardos	Los Cardos
maría susana	María Susana
piamonte	Piamonte
traill	Traill
cañada ombú	Cañada Ombú
fortín olmos	Fortín Olmos
garabato	Garabato
golondrina	Golondrina
intiyaco	Intiyaco
la gallareta	La Gallareta
los amores	Los Amores
margarita	Margarita
tartagal, santa fe	Tartagal, Santa Fe
toba	Toba
municipalidad de burruyacu	Municipalidad de Burruyacu
municipalidad de san miguel de tucuman	Municipalidad de San Miguel De Tucuman
municipalidad de alderetes	Municipalidad de Alderetes
municipalidad de banda del  rio sali	Municipalidad de Banda del  Rio Sali
municipalidad de concepcion	Municipalidad de Concepcion
municipalidad de famailla	Municipalidad de Famailla
municipalidad de graneros	Municipalidad de Graneros
municipalidad de juan bautista alberdi	Municipalidad de Juan Bautista Alberdi
municipalidad de la cocha	Municipalidad de la Cocha
municipalidad de bella vista	Municipalidad de Bella Vista
municipalidad de lules	Municipalidad de Lules
municipalidad de monteros	Municipalidad de Monteros
municipalidad de aguilares	Municipalidad de Aguilares
municipalidad de simoca	Municipalidad de Simoca
municipalidad de tafi del  valle	Municipalidad de Tafi del  Valle
municipalidad de las  talitas	Municipalidad de las  Talitas
municipalidad de tafi viejo	Municipalidad de Tafi Viejo
municipalidad de trancas	Municipalidad de Trancas
yerba buena	Yerba Buena
7 de abril	7 de Abril
el chañar	El Chañar
el naranjo y el sunchal	El Naranjo y el Sunchal
el puestito	El Puestito
el timbo	El Timbo
garmendia	Garmendia
gdor. piedrabuena	Gdor. Piedrabuena
la ramada y la cruz	La Ramada y la Cruz
benjamin araoz y el tajamar	Benjamin Araoz y el Tajamar
villa padre monti	Villa Padre Monti
colombres	Colombres
delfin gallo	Delfin Gallo
el bracho y el cevilar	El Bracho y el Cevilar
el naranjito	El Naranjito
la florida y luisiana	La Florida y Luisiana
las cejas	Las Cejas
los bulacios y los  villagras	Los Bulacios y los  Villagras
los pereyras	Los Pereyras
los perez	Los Perez
los ralos	Los Ralos
ranchillos y san miguel	Ranchillos y San Miguel
san andres	San Andres
alpachiri y el molino	Alpachiri y el Molino
alto verde y los  guchea	Alto Verde y los  Guchea
arcadia	Arcadia
gastona y belicha	Gastona y Belicha
trinidad	Trinidad
medina	Medina
lamadrid	Lamadrid
taco ralo	Taco Ralo
escaba	Escaba
comuna villa belgrano	Comuna Villa Belgrano
el sacrificio	El Sacrificio
huasa pampa	Huasa Pampa
rumipunco	Rumipunco
san ignacio, tucumán	San Ignacio, Tucumán
san jose de la cocha	San Jose de la Cocha
yanima	Yanima
agua dulce y la soledad	Agua Dulce y la Soledad
el mojon	El Mojon
esquina y mancopa	Esquina y Mancopa
estacion araoz y tacanas	Estacion Araoz y Tacanas
las talas	Las Talas
los gomez	Los Gomez
los puestos	Los Puestos
manuel garcia fernandez	Manuel Garcia Fernandez
quilmes y los  sueldos	Quilmes y los  Sueldos
rio colorado, tucumán	Rio Colorado, Tucumán
santa rosa de leales y l. blanca	Santa Rosa de Leales y L. Blanca
villa de leales	Villa de Leales
el manantial	El Manantial
san felipe y santa barbara	San Felipe y Santa Barbara
san pablo y villa nougues	San Pablo y Villa Nougues
acheral	Acheral
amberes	Amberes
capitan caceres	Capitan Caceres
el cercado	El Cercado
leon rouges y santa rosa	Leon Rouges y Santa Rosa
los sosa	Los Sosa
rio seco	Rio Seco
santa lucia	Santa Lucia
sargento moya	Sargento Moya
soldado maldonado	Soldado Maldonado
teniente berdina	Teniente Berdina
villa quinteros	Villa Quinteros
el polear	El Polear
los sarmiento y la tipa	Los Sarmiento y la Tipa
monte bello	Monte Bello
santa ana, tucumán	Santa Ana, Tucumán
atahona, tucumán	Atahona, Tucumán
buena vista, tucumán	Buena Vista, Tucumán
ciudacita	Ciudacita
manuela pedraza	Manuela Pedraza
monteagudo	Monteagudo
pampa mayo	Pampa Mayo
rio chico y nueva trinidad	Rio Chico y Nueva Trinidad
san pedro y san antonio	San Pedro y San Antonio
santa cruz y la tuna	Santa Cruz y la Tuna
villa de chicligasta	Villa de Chicligasta
municipalidad de yerba buena	Municipalidad de Yerba Buena
amaicha del  valle	Amaicha del  Valle
colalao del  valle	Colalao del  Valle
el mollar	El Mollar
raco	Raco
ancajuli	Ancajuli
el cadillal	El Cadillal
la esperanza, tucumán	La Esperanza, Tucumán
los nogales	Los Nogales
choromoro	Choromoro
san pedro de colalao	San Pedro de Colalao
tapia	Tapia
cevil redondo	Cevil Redondo
san javier, tucumán	San Javier, Tucumán
río grande	Río Grande
ushuaia	Ushuaia
tolhuin	Tolhuin
buenos aires	Buenos Aires
san miguel de tucumán	San Miguel de Tucumán
mar del plata	Mar del Plata
san juan	San Juan
santiago del estero	Santiago del Estero
paraná	Paraná
gonzález catán	González Catán
banfield	Banfield
isidro casanova	Isidro Casanova
la rioja	La Rioja
josé maría ezeiza	José María Ezeiza
san nicolás de los arroyos	San Nicolás de los Arroyos
catamarca	Catamarca
rafael castillo	Rafael Castillo
concordia	Concordia
san justo	San Justo
temperley	Temperley
ramos mejía	Ramos Mejía
mendoza	Mendoza
bernal	Bernal
gualeguaychú	Gualeguaychú
morón	Morón
la banda	La Banda
villa luzuriaga	Villa Luzuriaga
caseros	Caseros
burzaco	Burzaco
ciudad general belgrano	Ciudad General Belgrano
san francisco solano	San Francisco Solano
río gallegos	Río Gallegos
monte chingolo	Monte Chingolo
remedios de escalada	Remedios de Escalada
ezpeleta	Ezpeleta
villa celina	Villa Celina
lomas del mirador	Lomas del Mirador
wilde	Wilde
villa domínico	Villa Domínico
los polvorines	Los Polvorines
rafael calzada	Rafael Calzada
longchamps	Longchamps
villa alsina	Villa Alsina
josé mármol	José Mármol
haedo	Haedo
munro	Munro
dock sur	Dock Sur
villa adelina	Villa Adelina
adrogue	Adrogue
tapiales	Tapiales
don bosco	Don Bosco
villa sarmiento	Villa Sarmiento
aldo bonzi	Aldo Bonzi
gobernador gálvez	Gobernador Gálvez
concepción del uruguay	Concepción del Uruguay
sarandí	Sarandí
punta alta	Punta Alta
cruz del eje	Cruz del Eje
caleta olivia	Caleta Olivia
el talar de pacheco	El Talar de Pacheco
villaguay	Villaguay
la reja	La Reja
chajarí	Chajarí
gualeguay	Gualeguay
nueve de julio	Nueve de Julio
cutral-có	Cutral-Có
victoria	Victoria
san martín de los andes	San Martín de los Andes
el calafate	El Calafate
pico truncado	Pico Truncado
general martín miguel de güemes	General Martín Miguel de Güemes
federación	Federación
villa del rosario	Villa del Rosario
villa paranacito	Villa Paranacito
fray luis a. beltrán	Fray Luis A. Beltrán
puerto deseado	Puerto Deseado
añatuya	Añatuya
mar de ajó	Mar de Ajó
frías	Frías
puerto san martín	Puerto San Martín
rosario del tala	Rosario del Tala
san salvador	San Salvador
junín de los andes	Junín de los Andes
río colorado	Río Colorado
monte quemado	Monte Quemado
capilla del monte	Capilla del Monte
yacimiento río turbio	Yacimiento Río Turbio
jesús nazareno	Jesús Nazareno
san julián	San Julián
carhué	Carhué
general fernández oro	General Fernández Oro
comandante luis piedra buena	Comandante Luis Piedra Buena
ingeniero jacobacci	Ingeniero Jacobacci
ingeniero luis a. huergo	Ingeniero Luis A. Huergo
veintiocho de noviembre	Veintiocho de Noviembre
chepes	Chepes
general conesa	General Conesa
san antonio de los cobres	San Antonio de los Cobres
perito moreno	Perito Moreno
gobernador gregores	Gobernador Gregores
pampa del infierno	Pampa del Infierno
chumbicha	Chumbicha
trancas	Trancas
rodeo	Rodeo
pedro luro	Pedro Luro
darregueira	Darregueira
villalonga	Villalonga
uspallata	Uspallata
los blancos	Los Blancos
buenos aires, avellaneda	Avellaneda, Buenos Aires
buenos aires, general alvear	General Alvear, Buenos Aires
buenos aires, general belgrano	General Belgrano, Buenos Aires
buenos aires, general san martín	General San Martín, Buenos Aires
buenos aires, hipólito yrigoyen	Hipólito Yrigoyen, Buenos Aires
buenos aires, ituzaingó	Ituzaingó, Buenos Aires
buenos aires, junín	Junín, Buenos Aires
buenos aires, leandro n. alem	Leandro N. Alem, Buenos Aires
buenos aires, maipú	Maipú, Buenos Aires
buenos aires, malvinas argentinas	Malvinas Argentinas, Buenos Aires
buenos aires, mercedes	Mercedes, Buenos Aires
buenos aires, merlo	Merlo, Buenos Aires
buenos aires, 9 de julio	9 de Julio, Buenos Aires
buenos aires, pilar	Pilar, Buenos Aires
buenos aires, rivadavia	Rivadavia, Buenos Aires
buenos aires, saladillo	Saladillo, Buenos Aires
buenos aires, san fernando	San Fernando, Buenos Aires
buenos aires, san isidro	San Isidro, Buenos Aires
buenos aires, san miguel	San Miguel, Buenos Aires
buenos aires, san pedro	San Pedro, Buenos Aires
buenos aires, san vicente	San Vicente, Buenos Aires
buenos aires, 25 de mayo	25 de Mayo, Buenos Aires
catamarca, el rodeo	El Rodeo, Catamarca
catamarca, la puerta	La Puerta, Catamarca
catamarca, san fernando	San Fernando, Catamarca
catamarca, recreo	Recreo, Catamarca
catamarca, san josé	San José, Catamarca
catamarca, santa maría	Santa María, Catamarca
catamarca, santa rosa	Santa Rosa, Catamarca
córdoba, la cruz	La Cruz, Córdoba
córdoba, san agustín	San Agustín, Córdoba
córdoba, la calera	La Calera, Córdoba
córdoba, malvinas argentinas	Malvinas Argentinas, Córdoba
córdoba, coronel moldes	Coronel Moldes, Córdoba
córdoba, las vertientes	Las Vertientes, Córdoba
córdoba, santa catalina	Santa Catalina, Córdoba
córdoba, la puerta	La Puerta, Córdoba
córdoba, pilar	Pilar, Córdoba
córdoba, san pedro	San Pedro, Córdoba
córdoba, la paz	La Paz, Córdoba
córdoba, san josé	San José, Córdoba
córdoba, san francisco	San Francisco, Córdoba
córdoba, almafuerte	Almafuerte, Córdoba
córdoba, sarmiento	Sarmiento, Córdoba
córdoba, los molinos	Los Molinos, Córdoba
córdoba, san ignacio	San Ignacio, Córdoba
córdoba, ranqueles	Ranqueles, Córdoba
córdoba, avellaneda	Avellaneda, Córdoba
córdoba, saladillo	Saladillo, Córdoba
córdoba, las palmas	Las Palmas, Córdoba
córdoba, san roque	San Roque, Córdoba
córdoba, atahona	Atahona, Córdoba
córdoba, esquina	Esquina, Córdoba
córdoba, san lorenzo	San Lorenzo, Córdoba
córdoba, san vicente	San Vicente, Córdoba
córdoba, colonia iturraspe	Colonia Iturraspe, Córdoba
córdoba, el rodeo	El Rodeo, Córdoba
corrientes, colonia santa rosa	Colonia Santa Rosa, Corrientes
corrientes, esquina	Esquina, Corrientes
corrientes, alvear	Alvear, Corrientes
corrientes, carolina	Carolina, Corrientes
corrientes, san isidro	San Isidro, Corrientes
corrientes, ituzaingó	Ituzaingó, Corrientes
corrientes, san antonio	San Antonio, Corrientes
corrientes, san carlos	San Carlos, Corrientes
corrientes, lavalle	Lavalle, Corrientes
corrientes, mercedes	Mercedes, Corrientes
corrientes, bonpland	Bonpland, Corrientes
corrientes, san lorenzo	San Lorenzo, Corrientes
corrientes, santa ana	Santa Ana, Corrientes
corrientes, la cruz	La Cruz, Corrientes
corrientes, loreto	Loreto, Corrientes
corrientes, san miguel	San Miguel, Corrientes
corrientes, 9 de julio	9 de Julio, Corrientes
corrientes, san roque	San Roque, Corrientes
corrientes, santo tomé	Santo Tomé, Corrientes
chaco, las palmas	Las Palmas, Chaco
chaco, laguna blanca	Laguna Blanca, Chaco
chaco, general san martín	General San Martín, Chaco
chaco, san bernardo	San Bernardo, Chaco
chubut, sarmiento	Sarmiento, Chubut
formosa, general belgrano	General Belgrano, Formosa
formosa, general güemes	General Güemes, Formosa
formosa, laguna blanca	Laguna Blanca, Formosa
formosa, general mosconi	General Mosconi, Formosa
formosa, buena vista	Buena Vista, Formosa
jujuy, la esperanza	La Esperanza, Jujuy
jujuy, hipólito yrigoyen	Hipólito Yrigoyen, Jujuy
jujuy, san antonio	San Antonio, Jujuy
jujuy, santa catalina	Santa Catalina, Jujuy
jujuy, san francisco	San Francisco, Jujuy
jujuy, santa ana	Santa Ana, Jujuy
la pampa, general san martín	General San Martín, La Pampa
la pampa, santa isabel	Santa Isabel, La Pampa
la pampa, santa rosa	Santa Rosa, La Pampa
la pampa, santa teresa	Santa Teresa, La Pampa
la rioja, capital	Capital, La Rioja
la rioja, general belgrano	General Belgrano, La Rioja
la rioja, general san martín	General San Martín, La Rioja
mendoza, capital	Capital, Mendoza
mendoza, general alvear	General Alvear, Mendoza
mendoza, junín	Junín, Mendoza
mendoza, la paz	La Paz, Mendoza
mendoza, lavalle	Lavalle, Mendoza
mendoza, maipú	Maipú, Mendoza
mendoza, rivadavia	Rivadavia, Mendoza
mendoza, san carlos	San Carlos, Mendoza
mendoza, san martín	San Martín, Mendoza
mendoza, santa rosa	Santa Rosa, Mendoza
misiones, san josé	San José, Misiones
misiones, campo grande	Campo Grande, Misiones
misiones, bonpland	Bonpland, Misiones
misiones, candelaria	Candelaria, Misiones
misiones, loreto	Loreto, Misiones
misiones, santa ana	Santa Ana, Misiones
misiones, santa maría	Santa María, Misiones
misiones, 9 de julio	9 de Julio, Misiones
misiones, bernardo de irigoyen	Bernardo de Irigoyen, Misiones
misiones, san antonio	San Antonio, Misiones
misiones, san vicente	San Vicente, Misiones
misiones, almafuerte	Almafuerte, Misiones
misiones, leandro n. alem	Leandro N. Alem, Misiones
misiones, san martín	San Martín, Misiones
misiones, san ignacio	San Ignacio, Misiones
misiones, san javier	San Javier, Misiones
misiones, san pedro	San Pedro, Misiones
misiones, 25 de mayo	25 de Mayo, Misiones
neuquén, barrancas	Barrancas, Neuquén
río negro, campo grande	Campo Grande, Río Negro
río negro, rio colorado	Rio Colorado, Río Negro
salta, san lorenzo	San Lorenzo, Salta
salta, general güemes	General Güemes, Salta
salta, general mosconi	General Mosconi, Salta
salta, tartagal	Tartagal, Salta
salta, coronel moldes	Coronel Moldes, Salta
salta, colonia santa rosa	Colonia Santa Rosa, Salta
salta, hipólito yrigoyen	Hipólito Yrigoyen, Salta
salta, san carlos	San Carlos, Salta
san luis, candelaria	Candelaria, San Luis
san luis, san francisco	San Francisco, San Luis
san luis, ranqueles	Ranqueles, San Luis
san luis, merlo	Merlo, San Luis
san luis, leandro n. alem	Leandro N. Alem, San Luis
san luis, la calera	La Calera, San Luis
san luis, carolina	Carolina, San Luis
san luis, saladillo	Saladillo, San Luis
san luis, las vertientes	Las Vertientes, San Luis
santa fe, avellaneda	Avellaneda, Santa Fe
santa fe, recreo	Recreo, Santa Fe
santa fe, santo tomé	Santo Tomé, Santa Fe
santa fe, san javier	San Javier, Santa Fe
santa fe, san lorenzo	San Lorenzo, Santa Fe
santa fe, los molinos	Los Molinos, Santa Fe
santa fe, colonia iturraspe	Colonia Iturraspe, Santa Fe
santa fe, san antonio	San Antonio, Santa Fe
santa fe, san vicente	San Vicente, Santa Fe
santa fe, santa teresa	Santa Teresa, Santa Fe
santa fe, santa isabel	Santa Isabel, Santa Fe
santa fe, ituzaingó	Ituzaingó, Santa Fe
santa fe, pilar	Pilar, Santa Fe
santa fe, rivadavia	Rivadavia, Santa Fe
santa fe, san agustín	San Agustín, Santa Fe
santa fe, sarmiento	Sarmiento, Santa Fe
santa fe, san bernardo	San Bernardo, Santa Fe
santa fe, alvear	Alvear, Santa Fe
santa fe, barrancas	Barrancas, Santa Fe
santa fe, bernardo de irigoyen	Bernardo de Irigoyen, Santa Fe
santa fe, san mart	San Mart, Santa Fe
santa fe, tartagal	Tartagal, Santa Fe
tucumán, san ignacio	San Ignacio, Tucumán
tucumán, rio colorado	Rio Colorado, Tucumán
tucumán, santa ana	Santa Ana, Tucumán
tucumán, atahona	Atahona, Tucumán
tucumán, buena vista	Buena Vista, Tucumán
tucumán, la esperanza	La Esperanza, Tucumán
tucumán, san javier	San Javier, Tucumán
avellaneda (buenos aires)	Avellaneda, Buenos Aires
general alvear (buenos aires)	General Alvear, Buenos Aires
general belgrano (buenos aires)	General Belgrano, Buenos Aires
general san martín (buenos aires)	General San Martín, Buenos Aires
hipólito yrigoyen (buenos aires)	Hipólito Yrigoyen, Buenos Aires
ituzaingó (buenos aires)	Ituzaingó, Buenos Aires
junín (buenos aires)	Junín, Buenos Aires
leandro n. alem (buenos aires)	Leandro N. Alem, Buenos Aires
maipú (buenos aires)	Maipú, Buenos Aires
malvinas argentinas (buenos aires)	Malvinas Argentinas, Buenos Aires
mercedes (buenos aires)	Mercedes, Buenos Aires
merlo (buenos aires)	Merlo, Buenos Aires
9 de julio (buenos aires)	9 de Julio, Buenos Aires
pilar (buenos aires)	Pilar, Buenos Aires
rivadavia (buenos aires)	Rivadavia, Buenos Aires
saladillo (buenos aires)	Saladillo, Buenos Aires
san fernando (buenos aires)	San Fernando, Buenos Aires
san isidro (buenos aires)	San Isidro, Buenos Aires
san miguel (buenos aires)	San Miguel, Buenos Aires
san pedro (buenos aires)	San Pedro, Buenos Aires
san vicente (buenos aires)	San Vicente, Buenos Aires
25 de mayo (buenos aires)	25 de Mayo, Buenos Aires
el rodeo (catamarca)	El Rodeo, Catamarca
la puerta (catamarca)	La Puerta, Catamarca
san fernando (catamarca)	San Fernando, Catamarca
recreo (catamarca)	Recreo, Catamarca
san josé (catamarca)	San José, Catamarca
santa maría (catamarca)	Santa María, Catamarca
santa rosa (catamarca)	Santa Rosa, Catamarca
la cruz (córdoba)	La Cruz, Córdoba
san agustín (córdoba)	San Agustín, Córdoba
la calera (córdoba)	La Calera, Córdoba
malvinas argentinas (córdoba)	Malvinas Argentinas, Córdoba
coronel moldes (córdoba)	Coronel Moldes, Córdoba
las vertientes (córdoba)	Las Vertientes, Córdoba
santa catalina (córdoba)	Santa Catalina, Córdoba
la puerta (córdoba)	La Puerta, Córdoba
pilar (córdoba)	Pilar, Córdoba
san pedro (córdoba)	San Pedro, Córdoba
la paz (córdoba)	La Paz, Córdoba
san josé (córdoba)	San José, Córdoba
san francisco (córdoba)	San Francisco, Córdoba
almafuerte (córdoba)	Almafuerte, Córdoba
sarmiento (córdoba)	Sarmiento, Córdoba
los molinos (córdoba)	Los Molinos, Córdoba
san ignacio (córdoba)	San Ignacio, Córdoba
ranqueles (córdoba)	Ranqueles, Córdoba
avellaneda (córdoba)	Avellaneda, Córdoba
saladillo (córdoba)	Saladillo, Córdoba
las palmas (córdoba)	Las Palmas, Córdoba
san roque (córdoba)	San Roque, Córdoba
atahona (córdoba)	Atahona, Córdoba
esquina (córdoba)	Esquina, Córdoba
san lorenzo (córdoba)	San Lorenzo, Córdoba
san vicente (córdoba)	San Vicente, Córdoba
colonia iturraspe (córdoba)	Colonia Iturraspe, Córdoba
el rodeo (córdoba)	El Rodeo, Córdoba
colonia santa rosa (corrientes)	Colonia Santa Rosa, Corrientes
esquina (corrientes)	Esquina, Corrientes
alvear (corrientes)	Alvear, Corrientes
carolina (corrientes)	Carolina, Corrientes
san isidro (corrientes)	San Isidro, Corrientes
ituzaingó (corrientes)	Ituzaingó, Corrientes
san antonio (corrientes)	San Antonio, Corrientes
san carlos (corrientes)	San Carlos, Corrientes
lavalle (corrientes)	Lavalle, Corrientes
mercedes (corrientes)	Mercedes, Corrientes
bonpland (corrientes)	Bonpland, Corrientes
san lorenzo (corrientes)	San Lorenzo, Corrientes
santa ana (corrientes)	Santa Ana, Corrientes
la cruz (corrientes)	La Cruz, Corrientes
loreto (corrientes)	Loreto, Corrientes
san miguel (corrientes)	San Miguel, Corrientes
9 de julio (corrientes)	9 de Julio, Corrientes
san roque (corrientes)	San Roque, Corrientes
santo tomé (corrientes)	Santo Tomé, Corrientes
las palmas (chaco)	Las Palmas, Chaco
laguna blanca (chaco)	Laguna Blanca, Chaco
general san martín (chaco)	General San Martín, Chaco
san bernardo (chaco)	San Bernardo, Chaco
sarmiento (chubut)	Sarmiento, Chubut
general belgrano (formosa)	General Belgrano, Formosa
general güemes (formosa)	General Güemes, Formosa
laguna blanca (formosa)	Laguna Blanca, Formosa
general mosconi (formosa)	General Mosconi, Formosa
buena vista (formosa)	Buena Vista, Formosa
la esperanza (jujuy)	La Esperanza, Jujuy
hipólito yrigoyen (jujuy)	Hipólito Yrigoyen, Jujuy
san antonio (jujuy)	San Antonio, Jujuy
santa catalina (jujuy)	Santa Catalina, Jujuy
san francisco (jujuy)	San Francisco, Jujuy
santa ana (jujuy)	Santa Ana, Jujuy
general san martín (la pampa)	General San Martín, La Pampa
santa isabel (la pampa)	Santa Isabel, La Pampa
santa rosa (la pampa)	Santa Rosa, La Pampa
santa teresa (la pampa)	Santa Teresa, La Pampa
capital (la rioja)	Capital, La Rioja
general belgrano (la rioja)	General Belgrano, La Rioja
general san martín (la rioja)	General San Martín, La Rioja
capital (mendoza)	Capital, Mendoza
general alvear (mendoza)	General Alvear, Mendoza
junín (mendoza)	Junín, Mendoza
la paz (mendoza)	La Paz, Mendoza
lavalle (mendoza)	Lavalle, Mendoza
maipú (mendoza)	Maipú, Mendoza
rivadavia (mendoza)	Rivadavia, Mendoza
san carlos (mendoza)	San Carlos, Mendoza
san martín (mendoza)	San Martín, Mendoza
santa rosa (mendoza)	Santa Rosa, Mendoza
san josé (misiones)	San José, Misiones
campo grande (misiones)	Campo Grande, Misiones
bonpland (misiones)	Bonpland, Misiones
candelaria (misiones)	Candelaria, Misiones
loreto (misiones)	Loreto, Misiones
santa ana (misiones)	Santa Ana, Misiones
santa maría (misiones)	Santa María, Misiones
9 de julio (misiones)	9 de Julio, Misiones
bernardo de irigoyen (misiones)	Bernardo de Irigoyen, Misiones
san antonio (misiones)	San Antonio, Misiones
san vicente (misiones)	San Vicente, Misiones
almafuerte (misiones)	Almafuerte, Misiones
leandro n. alem (misiones)	Leandro N. Alem, Misiones
san martín (misiones)	San Martín, Misiones
san ignacio (misiones)	San Ignacio, Misiones
san javier (misiones)	San Javier, Misiones
san pedro (misiones)	San Pedro, Misiones
25 de mayo (misiones)	25 de Mayo, Misiones
barrancas (neuquén)	Barrancas, Neuquén
campo grande (río negro)	Campo Grande, Río Negro
rio colorado (río negro)	Rio Colorado, Río Negro
san lorenzo (salta)	San Lorenzo, Salta
general güemes (salta)	General Güemes, Salta
general mosconi (salta)	General Mosconi, Salta
tartagal (salta)	Tartagal, Salta
coronel moldes (salta)	Coronel Moldes, Salta
colonia santa rosa (salta)	Colonia Santa Rosa, Salta
hipólito yrigoyen (salta)	Hipólito Yrigoyen, Salta
san carlos (salta)	San Carlos, Salta
candelaria (san luis)	Candelaria, San Luis
san francisco (san luis)	San Francisco, San Luis
ranqueles (san luis)	Ranqueles, San Luis
merlo (san luis)	Merlo, San Luis
leandro n. alem (san luis)	Leandro N. Alem, San Luis
la calera (san luis)	La Calera, San Luis
carolina (san luis)	Carolina, San Luis
saladillo (san luis)	Saladillo, San Luis
las vertientes (san luis)	Las Vertientes, San Luis
avellaneda (santa fe)	Avellaneda, Santa Fe
recreo (santa fe)	Recreo, Santa Fe
santo tomé (santa fe)	Santo Tomé, Santa Fe
san javier (santa fe)	San Javier, Santa Fe
san lorenzo (santa fe)	San Lorenzo, Santa Fe
los molinos (santa fe)	Los Molinos, Santa Fe
colonia iturraspe (santa fe)	Colonia Iturraspe, Santa Fe
san antonio (santa fe)	San Antonio, Santa Fe
san vicente (santa fe)	San Vicente, Santa Fe
santa teresa (santa fe)	Santa Teresa, Santa Fe
santa isabel (santa fe)	Santa Isabel, Santa Fe
ituzaingó (santa fe)	Ituzaingó, Santa Fe
pilar (santa fe)	Pilar, Santa Fe
rivadavia (santa fe)	Rivadavia, Santa Fe
san agustín (santa fe)	San Agustín, Santa Fe
sarmiento (santa fe)	Sarmiento, Santa Fe
san bernardo (santa fe)	San Bernardo, Santa Fe
alvear (santa fe)	Alvear, Santa Fe
barrancas (santa fe)	Barrancas, Santa Fe
bernardo de irigoyen (santa fe)	Bernardo de Irigoyen, Santa Fe
san mart (santa fe)	San Mart, Santa Fe
tartagal (santa fe)	Tartagal, Santa Fe
san ignacio (tucumán)	San Ignacio, Tucumán
rio colorado (tucumán)	Rio Colorado, Tucumán
santa ana (tucumán)	Santa Ana, Tucumán
atahona (tucumán)	Atahona, Tucumán
buena vista (tucumán)	Buena Vista, Tucumán
la esperanza (tucumán)	La Esperanza, Tucumán
san javier (tucumán)	San Javier, Tucumán
avellaneda(buenos aires)	Avellaneda, Buenos Aires
general alvear(buenos aires)	General Alvear, Buenos Aires
general belgrano(buenos aires)	General Belgrano, Buenos Aires
general san martín(buenos aires)	General San Martín, Buenos Aires
hipólito yrigoyen(buenos aires)	Hipólito Yrigoyen, Buenos Aires
ituzaingó(buenos aires)	Ituzaingó, Buenos Aires
junín(buenos aires)	Junín, Buenos Aires
leandro n. alem(buenos aires)	Leandro N. Alem, Buenos Aires
maipú(buenos aires)	Maipú, Buenos Aires
malvinas argentinas(buenos aires)	Malvinas Argentinas, Buenos Aires
mercedes(buenos aires)	Mercedes, Buenos Aires
merlo(buenos aires)	Merlo, Buenos Aires
9 de julio(buenos aires)	9 de Julio, Buenos Aires
pilar(buenos aires)	Pilar, Buenos Aires
rivadavia(buenos aires)	Rivadavia, Buenos Aires
saladillo(buenos aires)	Saladillo, Buenos Aires
san fernando(buenos aires)	San Fernando, Buenos Aires
san isidro(buenos aires)	San Isidro, Buenos Aires
san miguel(buenos aires)	San Miguel, Buenos Aires
san pedro(buenos aires)	San Pedro, Buenos Aires
san vicente(buenos aires)	San Vicente, Buenos Aires
25 de mayo(buenos aires)	25 de Mayo, Buenos Aires
el rodeo(catamarca)	El Rodeo, Catamarca
la puerta(catamarca)	La Puerta, Catamarca
san fernando(catamarca)	San Fernando, Catamarca
recreo(catamarca)	Recreo, Catamarca
san josé(catamarca)	San José, Catamarca
santa maría(catamarca)	Santa María, Catamarca
santa rosa(catamarca)	Santa Rosa, Catamarca
la cruz(córdoba)	La Cruz, Córdoba
san agustín(córdoba)	San Agustín, Córdoba
la calera(córdoba)	La Calera, Córdoba
malvinas argentinas(córdoba)	Malvinas Argentinas, Córdoba
coronel moldes(córdoba)	Coronel Moldes, Córdoba
las vertientes(córdoba)	Las Vertientes, Córdoba
santa catalina(córdoba)	Santa Catalina, Córdoba
la puerta(córdoba)	La Puerta, Córdoba
pilar(córdoba)	Pilar, Córdoba
san pedro(córdoba)	San Pedro, Córdoba
la paz(córdoba)	La Paz, Córdoba
san josé(córdoba)	San José, Córdoba
san francisco(córdoba)	San Francisco, Córdoba
almafuerte(córdoba)	Almafuerte, Córdoba
sarmiento(córdoba)	Sarmiento, Córdoba
los molinos(córdoba)	Los Molinos, Córdoba
san ignacio(córdoba)	San Ignacio, Córdoba
ranqueles(córdoba)	Ranqueles, Córdoba
avellaneda(córdoba)	Avellaneda, Córdoba
saladillo(córdoba)	Saladillo, Córdoba
las palmas(córdoba)	Las Palmas, Córdoba
san roque(córdoba)	San Roque, Córdoba
atahona(córdoba)	Atahona, Córdoba
esquina(córdoba)	Esquina, Córdoba
san lorenzo(córdoba)	San Lorenzo, Córdoba
san vicente(córdoba)	San Vicente, Córdoba
colonia iturraspe(córdoba)	Colonia Iturraspe, Córdoba
el rodeo(córdoba)	El Rodeo, Córdoba
colonia santa rosa(corrientes)	Colonia Santa Rosa, Corrientes
esquina(corrientes)	Esquina, Corrientes
alvear(corrientes)	Alvear, Corrientes
carolina(corrientes)	Carolina, Corrientes
san isidro(corrientes)	San Isidro, Corrientes
ituzaingó(corrientes)	Ituzaingó, Corrientes
san antonio(corrientes)	San Antonio, Corrientes
san carlos(corrientes)	San Carlos, Corrientes
lavalle(corrientes)	Lavalle, Corrientes
mercedes(corrientes)	Mercedes, Corrientes
bonpland(corrientes)	Bonpland, Corrientes
san lorenzo(corrientes)	San Lorenzo, Corrientes
santa ana(corrientes)	Santa Ana, Corrientes
la cruz(corrientes)	La Cruz, Corrientes
loreto(corrientes)	Loreto, Corrientes
san miguel(corrientes)	San Miguel, Corrientes
9 de julio(corrientes)	9 de Julio, Corrientes
san roque(corrientes)	San Roque, Corrientes
santo tomé(corrientes)	Santo Tomé, Corrientes
las palmas(chaco)	Las Palmas, Chaco
laguna blanca(chaco)	Laguna Blanca, Chaco
general san martín(chaco)	General San Martín, Chaco
san bernardo(chaco)	San Bernardo, Chaco
sarmiento(chubut)	Sarmiento, Chubut
general belgrano(formosa)	General Belgrano, Formosa
general güemes(formosa)	General Güemes, Formosa
laguna blanca(formosa)	Laguna Blanca, Formosa
general mosconi(formosa)	General Mosconi, Formosa
buena vista(formosa)	Buena Vista, Formosa
la esperanza(jujuy)	La Esperanza, Jujuy
hipólito yrigoyen(jujuy)	Hipólito Yrigoyen, Jujuy
san antonio(jujuy)	San Antonio, Jujuy
santa catalina(jujuy)	Santa Catalina, Jujuy
san francisco(jujuy)	San Francisco, Jujuy
santa ana(jujuy)	Santa Ana, Jujuy
general san martín(la pampa)	General San Martín, La Pampa
santa isabel(la pampa)	Santa Isabel, La Pampa
santa rosa(la pampa)	Santa Rosa, La Pampa
santa teresa(la pampa)	Santa Teresa, La Pampa
capital(la rioja)	Capital, La Rioja
general belgrano(la rioja)	General Belgrano, La Rioja
general san martín(la rioja)	General San Martín, La Rioja
capital(mendoza)	Capital, Mendoza
general alvear(mendoza)	General Alvear, Mendoza
junín(mendoza)	Junín, Mendoza
la paz(mendoza)	La Paz, Mendoza
lavalle(mendoza)	Lavalle, Mendoza
maipú(mendoza)	Maipú, Mendoza
rivadavia(mendoza)	Rivadavia, Mendoza
san carlos(mendoza)	San Carlos, Mendoza
san martín(mendoza)	San Martín, Mendoza
santa rosa(mendoza)	Santa Rosa, Mendoza
san josé(misiones)	San José, Misiones
campo grande(misiones)	Campo Grande, Misiones
bonpland(misiones)	Bonpland, Misiones
candelaria(misiones)	Candelaria, Misiones
loreto(misiones)	Loreto, Misiones
santa ana(misiones)	Santa Ana, Misiones
santa maría(misiones)	Santa María, Misiones
9 de julio(misiones)	9 de Julio, Misiones
bernardo de irigoyen(misiones)	Bernardo de Irigoyen, Misiones
san antonio(misiones)	San Antonio, Misiones
san vicente(misiones)	San Vicente, Misiones
almafuerte(misiones)	Almafuerte, Misiones
leandro n. alem(misiones)	Leandro N. Alem, Misiones
san martín(misiones)	San Martín, Misiones
san ignacio(misiones)	San Ignacio, Misiones
san javier(misiones)	San Javier, Misiones
san pedro(misiones)	San Pedro, Misiones
25 de mayo(misiones)	25 de Mayo, Misiones
barrancas(neuquén)	Barrancas, Neuquén
campo grande(río negro)	Campo Grande, Río Negro
rio colorado(río negro)	Rio Colorado, Río Negro
san lorenzo(salta)	San Lorenzo, Salta
general güemes(salta)	General Güemes, Salta
general mosconi(salta)	General Mosconi, Salta
tartagal(salta)	Tartagal, Salta
coronel moldes(salta)	Coronel Moldes, Salta
colonia santa rosa(salta)	Colonia Santa Rosa, Salta
hipólito yrigoyen(salta)	Hipólito Yrigoyen, Salta
san carlos(salta)	San Carlos, Salta
candelaria(san luis)	Candelaria, San Luis
san francisco(san luis)	San Francisco, San Luis
ranqueles(san luis)	Ranqueles, San Luis
merlo(san luis)	Merlo, San Luis
leandro n. alem(san luis)	Leandro N. Alem, San Luis
la calera(san luis)	La Calera, San Luis
carolina(san luis)	Carolina, San Luis
saladillo(san luis)	Saladillo, San Luis
las vertientes(san luis)	Las Vertientes, San Luis
avellaneda(santa fe)	Avellaneda, Santa Fe
recreo(santa fe)	Recreo, Santa Fe
santo tomé(santa fe)	Santo Tomé, Santa Fe
san javier(santa fe)	San Javier, Santa Fe
san lorenzo(santa fe)	San Lorenzo, Santa Fe
los molinos(santa fe)	Los Molinos, Santa Fe
colonia iturraspe(santa fe)	Colonia Iturraspe, Santa Fe
san antonio(santa fe)	San Antonio, Santa Fe
san vicente(santa fe)	San Vicente, Santa Fe
santa teresa(santa fe)	Santa Teresa, Santa Fe
santa isabel(santa fe)	Santa Isabel, Santa Fe
ituzaingó(santa fe)	Ituzaingó, Santa Fe
pilar(santa fe)	Pilar, Santa Fe
rivadavia(santa fe)	Rivadavia, Santa Fe
san agustín(santa fe)	San Agustín, Santa Fe
sarmiento(santa fe)	Sarmiento, Santa Fe
san bernardo(santa fe)	San Bernardo, Santa Fe
alvear(santa fe)	Alvear, Santa Fe
barrancas(santa fe)	Barrancas, Santa Fe
bernardo de irigoyen(santa fe)	Bernardo de Irigoyen, Santa Fe
san mart(santa fe)	San Mart, Santa Fe
tartagal(santa fe)	Tartagal, Santa Fe
san ignacio(tucumán)	San Ignacio, Tucumán
rio colorado(tucumán)	Rio Colorado, Tucumán
santa ana(tucumán)	Santa Ana, Tucumán
atahona(tucumán)	Atahona, Tucumán
buena vista(tucumán)	Buena Vista, Tucumán
la esperanza(tucumán)	La Esperanza, Tucumán
san javier(tucumán)	San Javier, Tucumán
bahia blanca	Bahía Blanca
benito juarez	Benito Juárez
bolivar	Bolívar
canuelas	Cañuelas
capitan sarmiento	Capitán Sarmiento
colon	Colón
coronel suarez	Coronel Suárez
chascomus	Chascomús
esteban echeverria	Esteban Echeverría
exaltacion de la cruz	Exaltación de la Cruz
general pueyrredon	General Pueyrredón
general rodriguez	General Rodríguez
general san martin, buenos aires	General San Martín, Buenos Aires
guamini	Guaminí
hipolito yrigoyen, buenos aires	Hipólito Yrigoyen, Buenos Aires
ituzaingo, buenos aires	Ituzaingó, Buenos Aires
jose c. paz	José C. Paz
junin, buenos aires	Junín, Buenos Aires
lanus	Lanús
loberia	Lobería
maipu, buenos aires	Maipú, Buenos Aires
olavarria	Olavarría
pehuajo	Pehuajó
presidente peron	Presidente Perón
puan	Puán
roque perez	Roque Pérez
salliquelo	Salliqueló
san andres de giles	San Andrés de Giles
san nicolas	San Nicolás
tapalque	Tapalqué
vicente lopez	Vicente López
zarate	Zárate
andalgala	Andalgalá
belen	Belén
hualfin	Hualfín
puerta de san jose	Puerta de San José
capayan	Capayán
fray mamerto esquiu	Fray Mamerto Esquiú
icano	Icaño
paclin	Paclín
mutquin	Mutquín
poman	Pomán
san jose, catamarca	San José, Catamarca
santa maria, catamarca	Santa María, Catamarca
fiambala	Fiambalá
la cruz, cordoba	La Cruz, Córdoba
los condores	Los Cóndores
rio de los  sauces	Río de los  Sauces
san agustin, cordoba	San Agustín, Córdoba
cordoba	Córdoba
estacion juarez celman	Estación Juárez Celman
jesus maria	Jesús María
la calera, cordoba	La Calera, Córdoba
malvinas argentinas, cordoba	Malvinas Argentinas, Córdoba
rio ceballos	Río Ceballos
saldan	Saldán
huinca renanco	Huinca Renancó
italo	Italó
chazon	Chazón
tio pujio	Tío Pujio
villa maria	Villa María
dean funes	Deán Funes
reduccion	Reducción
capitan general b. o'higgins	Capitán General B. O'Higgins
guatimozin	Guatimozín
marcos juarez	Marcos Juárez
bialet masse	Bialet Massé
cosquin	Cosquín
santa maria de punilla	Santa María de Punilla
adelia maria	Adelia María
berrotaran	Berrotarán
chajan	Chaján
coronel moldes, cordoba	Coronel Moldes, Córdoba
las vertientes, cordoba	Las Vertientes, Córdoba
rio cuarto	Río Cuarto
santa catalina, cordoba	Santa Catalina, Córdoba
vicuna mackenna	Vicuña Mackenna
la puerta, cordoba	La Puerta, Córdoba
piquillin	Piquillín
rio primero	Río Primero
santa rosa de rio primero	Santa Rosa de Río Primero
sebastian elcano	Sebastián Elcano
villa de maria	Villa de María
calchin	Calchín
calchin oeste	Calchín Oeste
pilar, cordoba	Pilar, Córdoba
rio segundo	Río Segundo
san pedro, cordoba	San Pedro, Córdoba
la paz, cordoba	La Paz, Córdoba
san jose, cordoba	San José, Córdoba
altos de chipion	Altos de Chipión
colonia san bartolome	Colonia San Bartolomé
el aranado	El Arañado
el fortin	El Fortín
el tio	El Tío
portena	Porteña
san francisco, cordoba	San Francisco, Córdoba
saturnino maria laspiur	Saturnino María Laspiur
transito	Tránsito
villa concepcion del  tio	Villa Concepción del  Tío
despenaderos	Despeñaderos
malagueno	Malagueño
san francisco del  chanar	San Francisco del  Chañar
almafuerte, cordoba	Almafuerte, Córdoba
dalmacio velez	Dalmacio Vélez
rio tercero	Río Tercero
canada de luque	Cañada de Luque
las penas	Las Peñas
sarmiento, cordoba	Sarmiento, Córdoba
san jose de la dormida	San José de la Dormida
san jose de las  salinas	San José de las  Salinas
benjamin gould	Benjamín Gould
monte lena	Monte Leña
monte maiz	Monte Maíz
ordonez	Ordóñez
san antonio de litin	San Antonio de Litín
canada del  sauce	Cañada del  Sauce
los molinos, cordoba	Los Molinos, Córdoba
san ignacio, cordoba	San Ignacio, Córdoba
colonia vicente aguero	Colonia Vicente Agüero
estacion general paz	Estación General Paz
banado de soto	Bañado de Soto
cruz de cana	Cruz de Caña
las canadas	Las Cañadas
los chanaritos (c.d. eje)	Los Chañaritos (C.D. Eje)
nicolas bruzzone	Nicolás Bruzzone
ranqueles, cordoba	Ranqueles, Córdoba
avellaneda, cordoba	Avellaneda, Córdoba
canada de rio pinto	Cañada de Río Pinto
chuna	Chuña
olivares de san nicolas	Olivares de San Nicolás
villa gutierrez	Villa Gutiérrez
saladillo, cordoba	Saladillo, Córdoba
cienaga del  coro	Ciénaga del  Coro
chancani	Chancaní
las palmas, cordoba	Las Palmas, Córdoba
san geronimo	San Gerónimo
tala canada	Tala Cañada
leguizamon	Leguizamón
rio bamba	Río Bamba
san joaquin	San Joaquín
san roque, cordoba	San Roque, Córdoba
villa rio icho cruz	Villa Río Icho Cruz
las penas sud	Las Peñas Sud
atahona, cordoba	Atahona, Córdoba
canada de machado	Cañada de Machado
el crispin	El Crispín
esquina, cordoba	Esquina, Córdoba
kilometro 658	Kilómetro 658
chanar viejo	Chañar Viejo
gutemberg	Gütemberg
los chanaritos	Los Chañaritos
rincon	Rincón
san lorenzo, cordoba	San Lorenzo, Córdoba
san vicente, cordoba	San Vicente, Córdoba
la poblacion	La Población
colonia iturraspe, cordoba	Colonia Iturraspe, Córdoba
rafael garcia	Rafael García
villa ciudad de america	Villa Ciudad de América
chuna huasi	Chuña Huasi
capilla del  siton	Capilla del  Sitón
churqui canada	Churqui Cañada
el rodeo, cordoba	El Rodeo, Córdoba
aldea santa maria	Aldea Santa María
ana zumaran	Ana Zumarán
beron de astrada	Berón de Astrada
concepcion	Concepción
tatacua	Tatacuá
curuzu cuatia	Curuzú Cuatiá
perugorria	Perugorría
estacion torrent	Estación Torrent
caa cati	Caá Catí
ita ibate	Itá Ibaté
itati	Itatí
ituzaingo, corrientes	Ituzaingó, Corrientes
gobernador martinez	Gobernador Martínez
yatayti calle	Yataytí Calle
mburucuya	Mburucuyá
felipe yofre	Felipe Yofré
mocoreta	Mocoretá
tapebicua	Tapebicuá
guaviravi	Guaviraví
yapeyu	Yapeyú
pedro r. fernandez	Pedro R. Fernández
chavarria	Chavarría
gobernador ing. valentin virasoro	Gobernador Ing. Valentín Virasoro
santo tome, corrientes	Santo Tomé, Corrientes
concepcion del  bermejo	Concepción del  Bermejo
puerto eva peron	Puerto Eva Perón
presidencia roque saenz pena	Presidencia Roque Sáenz Peña
makalle	Makallé
mision nueva pompeya	Misión Nueva Pompeya
juan jose castelli	Juan José Castelli
villa rio bermejito	Villa Río Bermejito
general san martin, chaco	General San Martín, Chaco
pampa almiron	Pampa Almirón
villa angela	Villa Ángela
las brenas	Las Breñas
samuhu	Samuhú
capitan solari	Capitán Solari
el maiten	El Maitén
epuyen	Epuyén
trevelin	Trevelín
alto rio senguer	Alto Río Senguer
rio mayo	Río Mayo
jose de san martin	José de San Martín
rio pico	Río Pico
puerto piramides	Puerto Pirámides
carrenleufu	Carrenleufú
colan conhue	Colan Conhué
mision san francisco de laishi	Misión San Francisco de Laishí
ingeniero guillermo n. juarez	Ingeniero Guillermo N. Juárez
general guemes, formosa	General Güemes, Formosa
san martin dos	San Martín Dos
mision taacagle	Misión Taacaglé
mayor vicente e. villafane	Mayor Vicente E. Villafañe
pirane	Pirané
fortin lugones	Fortín Lugones
subteniente perin	Subteniente Perín
porton negro	Portón Negro
libertador general san martin	Libertador General San Martín
palpala	Palpalá
abdon castro tolay	Abdón Castro Tolay
puesto del  marques	Puesto del  Marqués
hipolito yrigoyen, jujuy	Hipólito Yrigoyen, Jujuy
rodeito	Rodeíto
rosario de rio grande	Rosario de Río Grande
maimara	Maimará
volcan	Volcán
caspala	Caspalá
el condor	El Cóndor
algarrobo del  aguila	Algarrobo del  Águila
caleufu	Caleufú
catrilo	Catriló
colonia baron	Colonia Barón
general san martin, la pampa	General San Martín, La Pampa
guatrache	Guatraché
macachin	Macachín
miguel cane	Miguel Cané
puelen	Puelén
quehue	Quehué
quemu quemu	Quemú Quemú
realico	Realicó
rolon	Rolón
telen	Telén
tomas manuel anchorena	Tomás Manuel Anchorena
vertiz	Vértiz
colonia santa maria	Colonia Santa María
cuchillo co	Cuchillo Có
loventue	Loventué
peru	Perú
quetrequen	Quetrequén
general angel vicente penaloza	General Ángel Vicente Peñaloza
general san martin, la rioja	General San Martín, La Rioja
rosario vera penaloza	Rosario Vera Peñaloza
guaymallen	Guaymallén
junin, mendoza	Junín, Mendoza
lujan de cuyo	Luján de Cuyo
maipu, mendoza	Maipú, Mendoza
malargue	Malargüe
san martin, mendoza	San Martín, Mendoza
tunuyan	Tunuyán
apostoles	Apóstoles
san jose, misiones	San José, Misiones
aristobulo del valle	Aristóbulo del Valle
cerro cora	Cerro Corá
martires	Mártires
garupa	Garupá
concepcion de la sierra	Concepción de la Sierra
santa maria, misiones	Santa María, Misiones
iguazu	Iguazú
caa yari	Caa Yarí
gobernador lopez	Gobernador López
capiovi	Capioví
el alcazar	El Alcázar
garuhape	Garuhapé
campo ramon	Campo Ramón
guarani	Guaraní
obera	Oberá
panambi	Panambí
san martin, misiones	San Martín, Misiones
hipolito irigoyen	Hipólito Irigoyen
jardin america	Jardín América
itacaruare	Itacaruaré
mojon grande	Mojón Grande
alumine	Aluminé
anelo	Añelo
san patricio del  chanar	San Patricio del  Chañar
piedra del  aguila	Piedra del  Águila
cutral co	Cutral Có
neuquen	Neuquén
villa el chocon	Villa el Chocón
junin de los  andes	Junín de los  Andes
san martin de los  andes	San Martín de los  Andes
loncopue	Loncopué
el huecu	El Huecú
taquimilan	Taquimilán
barrancas, neuquen	Barrancas, Neuquén
rincon de los  sauces	Rincón de los  Sauces
picun leufu	Picún Leufú
santo tomas	Santo Tomás
villa curi leuvu	Villa Curi Leuvú
guanacos	Guañacos
ramon castro	Ramón Castro
villa del  puente picun leufu	Villa del  Puente Picún Leufú
campo grande, rio negro	Campo Grande, Río Negro
norquinco	Ñorquinco
rio colorado, rio negro	Rio Colorado, Río Negro
joaquin v. gonzalez	Joaquín V. González
general guemes, salta	General Güemes, Salta
embarcacion	Embarcación
ballivian	Ballivián
isla de canas	Isla de Cañas
el jardin	El Jardín
la vina	La Viña
el galpon	El Galpón
rio piedras	Río Piedras
seclantas	Seclantás
hipolito yrigoyen, salta	Hipólito Yrigoyen, Salta
san ramon de la nueva oran	San Ramón de la Nueva Orán
animana	Animaná
villa constitucion	Villa Constitución
villa canas	Villa Cañás
canada de gomez	Cañada de Gómez
santo tome, santa fe	Santo Tomé, Santa Fe
perez	Pérez
villa gobernador galvez	Villa Gobernador Gálvez
san cristobal	San Cristóbal
galvez	Gálvez
capitan bermudez	Capitán Bermúdez
carcarana	Carcarañá
fray luis beltran	Fray Luis Beltrán
roldan	Roldán
el trebol	El Trébol
calchaqui	Calchaquí
berabevu	Berabevú
chanar ladeado	Chañar Ladeado
godeken	Gödeken
san jose de la esquina	San José de la Esquina
angelica	Angélica
estacion clucellas	Estación Clucellas
maria juana	María Juana
villa san jose	Villa San José
zenon pereyra	Zenón Pereyra
canada rica	Cañada Rica
empalme villa constitucion	Empalme Villa Constitución
juan bernabe molina	Juan Bernabé Molina
pavon	Pavón
pavon arriba	Pavón Arriba
cayasta	Cayastá
aaron castellanos	Aarón Castellanos
amenabar	Amenábar
canada del  ucle	Cañada del  Ucle
maria teresa	María Teresa
melincue	Melincué
el araza	El Arazá
el rabon	El Rabón
tacuarendi	Tacuarendí
puerto general san martin	Puerto General San Martín
lucio v. lopez	Lucio V. López
villa eloisa	Villa Eloísa
san jose del  rincon	San José del  Rincón
colonia san jose	Colonia San José
cululu	Cululú
hipatia	Hipatía
ituzaingo, santa fe	Ituzaingó, Santa Fe
maria luisa	María Luisa
san agustin, santa fe	San Agustín, Santa Fe
san jeronimo del  sauce	San Jerónimo del  Sauce
san jeronimo norte	San Jerónimo Norte
santa maria centro	Santa María Centro
santa maria norte	Santa María Norte
gregoria perez de denis	Gregoria Pérez de Denis
logrono	Logroño
alvarez	Álvarez
pinero	Piñero
pueblo munoz	Pueblo Muñoz
coronel dominguez	Coronel Domínguez
aguara grande	Aguará Grande
moises ville	Moisés Ville
nanducita	Ñanducita
cacique ariacaiquin	Cacique Ariacaiquín
colonia duran	Colonia Durán
desvio arijon	Desvío Arijón
diaz	Díaz
san fabian	San Fabián
la penca y caraguata	La Penca y Caraguatá
nare	Naré
pedro gomez cello	Pedro Gómez Cello
ramayon	Ramayón
san jeronimo sud	San Jerónimo Sud
timbues	Timbúes
canada rosquin	Cañada Rosquín
maria susana	María Susana
canada ombu	Cañada Ombú
fortin olmos	Fortín Olmos
el chanar	El Chañar
san ignacio, tucuman	San Ignacio, Tucumán
rio colorado, tucuman	Rio Colorado, Tucumán
santa ana, tucuman	Santa Ana, Tucumán
atahona, tucuman	Atahona, Tucumán
buena vista, tucuman	Buena Vista, Tucumán
la esperanza, tucuman	La Esperanza, Tucumán
san javier, tucuman	San Javier, Tucumán
rio grande	Río Grande
san miguel de tucuman	San Miguel de Tucumán
parana	Paraná
gonzalez catan	González Catán
jose maria ezeiza	José María Ezeiza
san nicolas de los arroyos	San Nicolás de los Arroyos
ramos mejia	Ramos Mejía
gualeguaychu	Gualeguaychú
moron	Morón
rio gallegos	Río Gallegos
villa dominico	Villa Domínico
jose marmol	José Mármol
gobernador galvez	Gobernador Gálvez
concepcion del uruguay	Concepción del Uruguay
sarandi	Sarandí
chajari	Chajarí
cutral-co	Cutral-Có
san martin de los andes	San Martín de los Andes
general martin miguel de guemes	General Martín Miguel de Güemes
federacion	Federación
fray luis a. beltran	Fray Luis A. Beltrán
anatuya	Añatuya
mar de ajo	Mar de Ajó
frias	Frías
puerto san martin	Puerto San Martín
junin de los andes	Junín de los Andes
rio colorado	Río Colorado
yacimiento rio turbio	Yacimiento Río Turbio
jesus nazareno	Jesús Nazareno
san julian	San Julián
carhue	Carhué
general fernandez oro	General Fernández Oro
buenos aires, general san martin	General San Martín, Buenos Aires
buenos aires, hipolito yrigoyen	Hipólito Yrigoyen, Buenos Aires
buenos aires, ituzaingo	Ituzaingó, Buenos Aires
buenos aires, junin	Junín, Buenos Aires
buenos aires, maipu	Maipú, Buenos Aires
catamarca, san jose	San José, Catamarca
catamarca, santa maria	Santa María, Catamarca
cordoba, la cruz	La Cruz, Córdoba
cordoba, san agustin	San Agustín, Córdoba
cordoba, la calera	La Calera, Córdoba
cordoba, malvinas argentinas	Malvinas Argentinas, Córdoba
cordoba, coronel moldes	Coronel Moldes, Córdoba
cordoba, las vertientes	Las Vertientes, Córdoba
cordoba, santa catalina	Santa Catalina, Córdoba
cordoba, la puerta	La Puerta, Córdoba
cordoba, pilar	Pilar, Córdoba
cordoba, san pedro	San Pedro, Córdoba
cordoba, la paz	La Paz, Córdoba
cordoba, san jose	San José, Córdoba
cordoba, san francisco	San Francisco, Córdoba
cordoba, almafuerte	Almafuerte, Córdoba
cordoba, sarmiento	Sarmiento, Córdoba
cordoba, los molinos	Los Molinos, Córdoba
cordoba, san ignacio	San Ignacio, Córdoba
cordoba, ranqueles	Ranqueles, Córdoba
cordoba, avellaneda	Avellaneda, Córdoba
cordoba, saladillo	Saladillo, Córdoba
cordoba, las palmas	Las Palmas, Córdoba
cordoba, san roque	San Roque, Córdoba
cordoba, atahona	Atahona, Córdoba
cordoba, esquina	Esquina, Córdoba
cordoba, san lorenzo	San Lorenzo, Córdoba
cordoba, san vicente	San Vicente, Córdoba
cordoba, colonia iturraspe	Colonia Iturraspe, Córdoba
cordoba, el rodeo	El Rodeo, Córdoba
corrientes, ituzaingo	Ituzaingó, Corrientes
corrientes, santo tome	Santo Tomé, Corrientes
chaco, general san martin	General San Martín, Chaco
formosa, general guemes	General Güemes, Formosa
jujuy, hipolito yrigoyen	Hipólito Yrigoyen, Jujuy
la pampa, general san martin	General San Martín, La Pampa
la rioja, general san martin	General San Martín, La Rioja
mendoza, junin	Junín, Mendoza
mendoza, maipu	Maipú, Mendoza
mendoza, san martin	San Martín, Mendoza
misiones, san jose	San José, Misiones
misiones, santa maria	Santa María, Misiones
misiones, san martin	San Martín, Misiones
neuquen, barrancas	Barrancas, Neuquén
rio negro, campo grande	Campo Grande, Río Negro
rio negro, rio colorado	Rio Colorado, Río Negro
salta, general guemes	General Güemes, Salta
salta, hipolito yrigoyen	Hipólito Yrigoyen, Salta
santa fe, santo tome	Santo Tomé, Santa Fe
santa fe, ituzaingo	Ituzaingó, Santa Fe
santa fe, san agustin	San Agustín, Santa Fe
tucuman, san ignacio	San Ignacio, Tucumán
tucuman, rio colorado	Rio Colorado, Tucumán
tucuman, santa ana	Santa Ana, Tucumán
tucuman, atahona	Atahona, Tucumán
tucuman, buena vista	Buena Vista, Tucumán
tucuman, la esperanza	La Esperanza, Tucumán
tucuman, san javier	San Javier, Tucumán
general san martin (buenos aires)	General San Martín, Buenos Aires
hipolito yrigoyen (buenos aires)	Hipólito Yrigoyen, Buenos Aires
ituzaingo (buenos aires)	Ituzaingó, Buenos Aires
junin (buenos aires)	Junín, Buenos Aires
maipu (buenos aires)	Maipú, Buenos Aires
san jose (catamarca)	San José, Catamarca
santa maria (catamarca)	Santa María, Catamarca
la cruz (cordoba)	La Cruz, Córdoba
san agustin (cordoba)	San Agustín, Córdoba
la calera (cordoba)	La Calera, Córdoba
malvinas argentinas (cordoba)	Malvinas Argentinas, Córdoba
coronel moldes (cordoba)	Coronel Moldes, Córdoba
las vertientes (cordoba)	Las Vertientes, Córdoba
santa catalina (cordoba)	Santa Catalina, Córdoba
la puerta (cordoba)	La Puerta, Córdoba
pilar (cordoba)	Pilar, Córdoba
san pedro (cordoba)	San Pedro, Córdoba
la paz (cordoba)	La Paz, Córdoba
san jose (cordoba)	San José, Córdoba
san francisco (cordoba)	San Francisco, Córdoba
almafuerte (cordoba)	Almafuerte, Córdoba
sarmiento (cordoba)	Sarmiento, Córdoba
los molinos (cordoba)	Los Molinos, Córdoba
san ignacio (cordoba)	San Ignacio, Córdoba
ranqueles (cordoba)	Ranqueles, Córdoba
avellaneda (cordoba)	Avellaneda, Córdoba
saladillo (cordoba)	Saladillo, Córdoba
las palmas (cordoba)	Las Palmas, Córdoba
san roque (cordoba)	San Roque, Córdoba
atahona (cordoba)	Atahona, Córdoba
esquina (cordoba)	Esquina, Córdoba
san lorenzo (cordoba)	San Lorenzo, Córdoba
san vicente (cordoba)	San Vicente, Córdoba
colonia iturraspe (cordoba)	Colonia Iturraspe, Córdoba
el rodeo (cordoba)	El Rodeo, Córdoba
ituzaingo (corrientes)	Ituzaingó, Corrientes
santo tome (corrientes)	Santo Tomé, Corrientes
general san martin (chaco)	General San Martín, Chaco
general guemes (formosa)	General Güemes, Formosa
hipolito yrigoyen (jujuy)	Hipólito Yrigoyen, Jujuy
general san martin (la pampa)	General San Martín, La Pampa
general san martin (la rioja)	General San Martín, La Rioja
junin (mendoza)	Junín, Mendoza
maipu (mendoza)	Maipú, Mendoza
san martin (mendoza)	San Martín, Mendoza
san jose (misiones)	San José, Misiones
santa maria (misiones)	Santa María, Misiones
san martin (misiones)	San Martín, Misiones
barrancas (neuquen)	Barrancas, Neuquén
campo grande (rio negro)	Campo Grande, Río Negro
rio colorado (rio negro)	Rio Colorado, Río Negro
general guemes (salta)	General Güemes, Salta
hipolito yrigoyen (salta)	Hipólito Yrigoyen, Salta
santo tome (santa fe)	Santo Tomé, Santa Fe
ituzaingo (santa fe)	Ituzaingó, Santa Fe
san agustin (santa fe)	San Agustín, Santa Fe
san ignacio (tucuman)	San Ignacio, Tucumán
rio colorado (tucuman)	Rio Colorado, Tucumán
santa ana (tucuman)	Santa Ana, Tucumán
atahona (tucuman)	Atahona, Tucumán
buena vista (tucuman)	Buena Vista, Tucumán
la esperanza (tucuman)	La Esperanza, Tucumán
san javier (tucuman)	San Javier, Tucumán
general san martin(buenos aires)	General San Martín, Buenos Aires
hipolito yrigoyen(buenos aires)	Hipólito Yrigoyen, Buenos Aires
ituzaingo(buenos aires)	Ituzaingó, Buenos Aires
junin(buenos aires)	Junín, Buenos Aires
maipu(buenos aires)	Maipú, Buenos Aires
san jose(catamarca)	San José, Catamarca
santa maria(catamarca)	Santa María, Catamarca
la cruz(cordoba)	La Cruz, Córdoba
san agustin(cordoba)	San Agustín, Córdoba
la calera(cordoba)	La Calera, Córdoba
malvinas argentinas(cordoba)	Malvinas Argentinas, Córdoba
coronel moldes(cordoba)	Coronel Moldes, Córdoba
las vertientes(cordoba)	Las Vertientes, Córdoba
santa catalina(cordoba)	Santa Catalina, Córdoba
la puerta(cordoba)	La Puerta, Córdoba
pilar(cordoba)	Pilar, Córdoba
san pedro(cordoba)	San Pedro, Córdoba
la paz(cordoba)	La Paz, Córdoba
san jose(cordoba)	San José, Córdoba
san francisco(cordoba)	San Francisco, Córdoba
almafuerte(cordoba)	Almafuerte, Córdoba
sarmiento(cordoba)	Sarmiento, Córdoba
los molinos(cordoba)	Los Molinos, Córdoba
san ignacio(cordoba)	San Ignacio, Córdoba
ranqueles(cordoba)	Ranqueles, Córdoba
avellaneda(cordoba)	Avellaneda, Córdoba
saladillo(cordoba)	Saladillo, Córdoba
las palmas(cordoba)	Las Palmas, Córdoba
san roque(cordoba)	San Roque, Córdoba
atahona(cordoba)	Atahona, Córdoba
esquina(cordoba)	Esquina, Córdoba
san lorenzo(cordoba)	San Lorenzo, Córdoba
san vicente(cordoba)	San Vicente, Córdoba
colonia iturraspe(cordoba)	Colonia Iturraspe, Córdoba
el rodeo(cordoba)	El Rodeo, Córdoba
ituzaingo(corrientes)	Ituzaingó, Corrientes
santo tome(corrientes)	Santo Tomé, Corrientes
general san martin(chaco)	General San Martín, Chaco
general guemes(formosa)	General Güemes, Formosa
hipolito yrigoyen(jujuy)	Hipólito Yrigoyen, Jujuy
general san martin(la pampa)	General San Martín, La Pampa
general san martin(la rioja)	General San Martín, La Rioja
junin(mendoza)	Junín, Mendoza
maipu(mendoza)	Maipú, Mendoza
san martin(mendoza)	San Martín, Mendoza
san jose(misiones)	San José, Misiones
santa maria(misiones)	Santa María, Misiones
san martin(misiones)	San Martín, Misiones
barrancas(neuquen)	Barrancas, Neuquén
campo grande(rio negro)	Campo Grande, Río Negro
rio colorado(rio negro)	Rio Colorado, Río Negro
general guemes(salta)	General Güemes, Salta
hipolito yrigoyen(salta)	Hipólito Yrigoyen, Salta
santo tome(santa fe)	Santo Tomé, Santa Fe
ituzaingo(santa fe)	Ituzaingó, Santa Fe
san agustin(santa fe)	San Agustín, Santa Fe
san ignacio(tucuman)	San Ignacio, Tucumán
rio colorado(tucuman)	Rio Colorado, Tucumán
santa ana(tucuman)	Santa Ana, Tucumán
atahona(tucuman)	Atahona, Tucumán
buena vista(tucuman)	Buena Vista, Tucumán
la esperanza(tucuman)	La Esperanza, Tucumán
san javier(tucuman)	San Javier, Tucumán
bahía blanca	Bahía Blanca
benito juárez	Benito Juárez
bolívar	Bolívar
cañuelas	Cañuelas
capitán sarmiento	Capitán Sarmiento
colón	Colón
coronel suárez	Coronel Suárez
chascomús	Chascomús
esteban echeverría	Esteban Echeverría
exaltación de la cruz	Exaltación de la Cruz
general pueyrredón	General Pueyrredón
general rodríguez	General Rodríguez
general san martín, buenos aires	General San Martín, Buenos Aires
guaminí	Guaminí
hipólito yrigoyen, buenos aires	Hipólito Yrigoyen, Buenos Aires
ituzaingó, buenos aires	Ituzaingó, Buenos Aires
josé c. paz	José C. Paz
junín, buenos aires	Junín, Buenos Aires
lanús	Lanús
lobería	Lobería
luján	Luján
maipú, buenos aires	Maipú, Buenos Aires
olavarría	Olavarría
pehuajó	Pehuajó
presidente perón	Presidente Perón
puán	Puán
roque pérez	Roque Pérez
salliqueló	Salliqueló
san andrés de giles	San Andrés de Giles
san nicolás	San Nicolás
tapalqué	Tapalqué
vicente lópez	Vicente López
zárate	Zárate
andalgalá	Andalgalá
belén	Belén
hualfín	Hualfín
puerta de san josé	Puerta de San José
capayán	Capayán
fray mamerto esquiú	Fray Mamerto Esquiú
icaño	Icaño
paclín	Paclín
mutquín	Mutquín
pomán	Pomán
san josé, catamarca	San José, Catamarca
santa maría, catamarca	Santa María, Catamarca
fiambalá	Fiambalá
la cruz, córdoba	La Cruz, Córdoba
los cóndores	Los Cóndores
río de los  sauces	Río de los  Sauces
san agustín, córdoba	San Agustín, Córdoba
córdoba	Córdoba
estación juárez celman	Estación Juárez Celman
jesús maría	Jesús María
la calera, córdoba	La Calera, Córdoba
malvinas argentinas, córdoba	Malvinas Argentinas, Córdoba
río ceballos	Río Ceballos
saldán	Saldán
huinca renancó	Huinca Renancó
italó	Italó
chazón	Chazón
tío pujio	Tío Pujio
villa maría	Villa María
deán funes	Deán Funes
reducción	Reducción
capitán general b. o'higgins	Capitán General B. O'Higgins
guatimozín	Guatimozín
marcos juárez	Marcos Juárez
bialet massé	Bialet Massé
cosquín	Cosquín
santa maría de punilla	Santa María de Punilla
adelia maría	Adelia María
berrotarán	Berrotarán
chaján	Chaján
coronel moldes, córdoba	Coronel Moldes, Córdoba
las vertientes, córdoba	Las Vertientes, Córdoba
río cuarto	Río Cuarto
santa catalina, córdoba	Santa Catalina, Córdoba
vicuña mackenna	Vicuña Mackenna
la puerta, córdoba	La Puerta, Córdoba
piquillín	Piquillín
río primero	Río Primero
santa rosa de río primero	Santa Rosa de Río Primero
sebastián elcano	Sebastián Elcano
villa de maría	Villa de María
calchín	Calchín
calchín oeste	Calchín Oeste
pilar, córdoba	Pilar, Córdoba
río segundo	Río Segundo
san pedro, córdoba	San Pedro, Córdoba
la paz, córdoba	La Paz, Córdoba
san josé, córdoba	San José, Córdoba
altos de chipión	Altos de Chipión
colonia san bartolomé	Colonia San Bartolomé
el arañado	El Arañado
el fortín	El Fortín
el tío	El Tío
porteña	Porteña
san francisco, córdoba	San Francisco, Córdoba
saturnino maría laspiur	Saturnino María Laspiur
tránsito	Tránsito
villa concepción del  tío	Villa Concepción del  Tío
despeñaderos	Despeñaderos
malagueño	Malagueño
san francisco del  chañar	San Francisco del  Chañar
almafuerte, córdoba	Almafuerte, Córdoba
dalmacio vélez	Dalmacio Vélez
río tercero	Río Tercero
cañada de luque	Cañada de Luque
las peñas	Las Peñas
sarmiento, córdoba	Sarmiento, Córdoba
san josé de la dormida	San José de la Dormida
san josé de las  salinas	San José de las  Salinas
benjamín gould	Benjamín Gould
monte leña	Monte Leña
monte maíz	Monte Maíz
ordóñez	Ordóñez
san antonio de litín	San Antonio de Litín
cañada del  sauce	Cañada del  Sauce
los molinos, córdoba	Los Molinos, Córdoba
san ignacio, córdoba	San Ignacio, Córdoba
colonia vicente agüero	Colonia Vicente Agüero
estación general paz	Estación General Paz
bañado de soto	Bañado de Soto
cruz de caña	Cruz de Caña
las cañadas	Las Cañadas
los chañaritos (c.d. eje)	Los Chañaritos (C.D. Eje)
nicolás bruzzone	Nicolás Bruzzone
ranqueles, córdoba	Ranqueles, Córdoba
avellaneda, córdoba	Avellaneda, Córdoba
cañada de río pinto	Cañada de Río Pinto
chuña	Chuña
olivares de san nicolás	Olivares de San Nicolás
villa gutiérrez	Villa Gutiérrez
saladillo, córdoba	Saladillo, Córdoba
ciénaga del  coro	Ciénaga del  Coro
chancaní	Chancaní
las palmas, córdoba	Las Palmas, Córdoba
san gerónimo	San Gerónimo
tala cañada	Tala Cañada
leguizamón	Leguizamón
río bamba	Río Bamba
san joaquín	San Joaquín
san roque, córdoba	San Roque, Córdoba
villa río icho cruz	Villa Río Icho Cruz
las peñas sud	Las Peñas Sud
atahona, córdoba	Atahona, Córdoba
cañada de machado	Cañada de Machado
el crispín	El Crispín
esquina, córdoba	Esquina, Córdoba
kilómetro 658	Kilómetro 658
chañar viejo	Chañar Viejo
gütemberg	Gütemberg
los chañaritos	Los Chañaritos
rincón	Rincón
san lorenzo, córdoba	San Lorenzo, Córdoba
san vicente, córdoba	San Vicente, Córdoba
la población	La Población
colonia iturraspe, córdoba	Colonia Iturraspe, Córdoba
rafael garcía	Rafael García
villa ciudad de américa	Villa Ciudad de América
chuña huasi	Chuña Huasi
capilla del  sitón	Capilla del  Sitón
churqui cañada	Churqui Cañada
el rodeo, córdoba	El Rodeo, Córdoba
aldea santa maría	Aldea Santa María
ana zumarán	Ana Zumarán
berón de astrada	Berón de Astrada
concepción	Concepción
tatacuá	Tatacuá
curuzú cuatiá	Curuzú Cuatiá
perugorría	Perugorría
estación torrent	Estación Torrent
caá catí	Caá Catí
itá ibaté	Itá Ibaté
itatí	Itatí
ituzaingó, corrientes	Ituzaingó, Corrientes
gobernador martínez	Gobernador Martínez
santa lucía	Santa Lucía
yataytí calle	Yataytí Calle
mburucuyá	Mburucuyá
felipe yofré	Felipe Yofré
mocoretá	Mocoretá
tapebicuá	Tapebicuá
guaviraví	Guaviraví
yapeyú	Yapeyú
pedro r. fernández	Pedro R. Fernández
chavarría	Chavarría
gobernador ing. valentín virasoro	Gobernador Ing. Valentín Virasoro
santo tomé, corrientes	Santo Tomé, Corrientes
concepción del  bermejo	Concepción del  Bermejo
puerto eva perón	Puerto Eva Perón
presidencia roque sáenz peña	Presidencia Roque Sáenz Peña
makallé	Makallé
misión nueva pompeya	Misión Nueva Pompeya
juan josé castelli	Juan José Castelli
villa río bermejito	Villa Río Bermejito
general san martín, chaco	General San Martín, Chaco
pampa almirón	Pampa Almirón
villa ángela	Villa Ángela
las breñas	Las Breñas
samuhú	Samuhú
capitán solari	Capitán Solari
el maitén	El Maitén
epuyén	Epuyén
trevelín	Trevelín
alto río senguer	Alto Río Senguer
río mayo	Río Mayo
josé de san martín	José de San Martín
río pico	Río Pico
puerto pirámides	Puerto Pirámides
carrenleufú	Carrenleufú
colan conhué	Colan Conhué
misión san francisco de laishí	Misión San Francisco de Laishí
ingeniero guillermo n. juárez	Ingeniero Guillermo N. Juárez
general güemes, formosa	General Güemes, Formosa
san martín dos	San Martín Dos
misión taacaglé	Misión Taacaglé
mayor vicente e. villafañe	Mayor Vicente E. Villafañe
pirané	Pirané
fortín lugones	Fortín Lugones
subteniente perín	Subteniente Perín
portón negro	Portón Negro
libertador general san martín	Libertador General San Martín
palpalá	Palpalá
abdón castro tolay	Abdón Castro Tolay
puesto del  marqués	Puesto del  Marqués
hipólito yrigoyen, jujuy	Hipólito Yrigoyen, Jujuy
rodeíto	Rodeíto
rosario de río grande	Rosario de Río Grande
maimará	Maimará
volcán	Volcán
caspalá	Caspalá
el cóndor	El Cóndor
algarrobo del  águila	Algarrobo del  Águila
caleufú	Caleufú
catriló	Catriló
colonia barón	Colonia Barón
general san martín, la pampa	General San Martín, La Pampa
guatraché	Guatraché
macachín	Macachín
miguel cané	Miguel Cané
puelén	Puelén
quehué	Quehué
quemú quemú	Quemú Quemú
realicó	Realicó
rolón	Rolón
telén	Telén
tomás manuel anchorena	Tomás Manuel Anchorena
vértiz	Vértiz
colonia santa maría	Colonia Santa María
cuchillo có	Cuchillo Có
loventué	Loventué
perú	Perú
quetrequén	Quetrequén
general ángel vicente peñaloza	General Ángel Vicente Peñaloza
general san martín, la rioja	General San Martín, La Rioja
rosario vera peñaloza	Rosario Vera Peñaloza
guaymallén	Guaymallén
junín, mendoza	Junín, Mendoza
luján de cuyo	Luján de Cuyo
maipú, mendoza	Maipú, Mendoza
malargüe	Malargüe
san martín, mendoza	San Martín, Mendoza
tunuyán	Tunuyán
apóstoles	Apóstoles
san josé, misiones	San José, Misiones
aristóbulo del valle	Aristóbulo del Valle
cerro corá	Cerro Corá
mártires	Mártires
garupá	Garupá
concepción de la sierra	Concepción de la Sierra
santa maría, misiones	Santa María, Misiones
iguazú	Iguazú
caa yarí	Caa Yarí
gobernador lópez	Gobernador López
capioví	Capioví
el alcázar	El Alcázar
garuhapé	Garuhapé
campo ramón	Campo Ramón
guaraní	Guaraní
oberá	Oberá
panambí	Panambí
san martín, misiones	San Martín, Misiones
hipólito irigoyen	Hipólito Irigoyen
jardín américa	Jardín América
itacaruaré	Itacaruaré
mojón grande	Mojón Grande
aluminé	Aluminé
añelo	Añelo
san patricio del  chañar	San Patricio del  Chañar
piedra del  águila	Piedra del  Águila
cutral có	Cutral Có
neuquén	Neuquén
villa el chocón	Villa el Chocón
junín de los  andes	Junín de los  Andes
san martín de los  andes	San Martín de los  Andes
loncopué	Loncopué
el huecú	El Huecú
taquimilán	Taquimilán
barrancas, neuquén	Barrancas, Neuquén
rincón de los  sauces	Rincón de los  Sauces
picún leufú	Picún Leufú
santo tomás	Santo Tomás
villa curi leuvú	Villa Curi Leuvú
guañacos	Guañacos
ramón castro	Ramón Castro
villa del  puente picún leufú	Villa del  Puente Picún Leufú
campo grande, río negro	Campo Grande, Río Negro
ñorquinco	Ñorquinco
rio colorado, río negro	Rio Colorado, Río Negro
joaquín v. gonzález	Joaquín V. González
general güemes, salta	General Güemes, Salta
embarcación	Embarcación
ballivián	Ballivián
isla de cañas	Isla de Cañas
el jardín	El Jardín
la viña	La Viña
el galpón	El Galpón
río piedras	Río Piedras
seclantás	Seclantás
hipólito yrigoyen, salta	Hipólito Yrigoyen, Salta
san ramón de la nueva orán	San Ramón de la Nueva Orán
animaná	Animaná
villa constitución	Villa Constitución
villa cañás	Villa Cañás
cañada de gómez	Cañada de Gómez
santo tomé, santa fe	Santo Tomé, Santa Fe
pérez	Pérez
villa gobernador gálvez	Villa Gobernador Gálvez
san cristóbal	San Cristóbal
gálvez	Gálvez
capitán bermúdez	Capitán Bermúdez
carcarañá	Carcarañá
fray luis beltrán	Fray Luis Beltrán
roldán	Roldán
el trébol	El Trébol
calchaquí	Calchaquí
berabevú	Berabevú
chañar ladeado	Chañar Ladeado
gödeken	Gödeken
san josé de la esquina	San José de la Esquina
angélica	Angélica
estación clucellas	Estación Clucellas
maría juana	María Juana
villa san josé	Villa San José
zenón pereyra	Zenón Pereyra
cañada rica	Cañada Rica
empalme villa constitución	Empalme Villa Constitución
juan bernabé molina	Juan Bernabé Molina
pavón	Pavón
pavón arriba	Pavón Arriba
cayastá	Cayastá
aarón castellanos	Aarón Castellanos
amenábar	Amenábar
cañada del  ucle	Cañada del  Ucle
maría teresa	María Teresa
melincué	Melincué
el arazá	El Arazá
el rabón	El Rabón
tacuarendí	Tacuarendí
puerto general san martín	Puerto General San Martín
lucio v. lópez	Lucio V. López
villa eloísa	Villa Eloísa
san josé del  rincón	San José del  Rincón
colonia san josé	Colonia San José
cululú	Cululú
hipatía	Hipatía
ituzaingó, santa fe	Ituzaingó, Santa Fe
maría luisa	María Luisa
san agustín, santa fe	San Agustín, Santa Fe
san jerónimo del  sauce	San Jerónimo del  Sauce
san jerónimo norte	San Jerónimo Norte
santa maría centro	Santa María Centro
santa maría norte	Santa María Norte
gregoria pérez de denis	Gregoria Pérez de Denis
logroño	Logroño
álvarez	Álvarez
piñero	Piñero
pueblo muñoz	Pueblo Muñoz
coronel domínguez	Coronel Domínguez
aguará grande	Aguará Grande
moisés ville	Moisés Ville
ñanducita	Ñanducita
cacique ariacaiquín	Cacique Ariacaiquín
colonia durán	Colonia Durán
desvío arijón	Desvío Arijón
díaz	Díaz
san fabián	San Fabián
la penca y caraguatá	La Penca y Caraguatá
naré	Naré
pedro gómez cello	Pedro Gómez Cello
ramayón	Ramayón
san jerónimo sud	San Jerónimo Sud
timbúes	Timbúes
cañada rosquín	Cañada Rosquín
maría susana	María Susana
cañada ombú	Cañada Ombú
fortín olmos	Fortín Olmos
el chañar	El Chañar
san ignacio, tucumán	San Ignacio, Tucumán
rio colorado, tucumán	Rio Colorado, Tucumán
santa ana, tucumán	Santa Ana, Tucumán
atahona, tucumán	Atahona, Tucumán
buena vista, tucumán	Buena Vista, Tucumán
la esperanza, tucumán	La Esperanza, Tucumán
san javier, tucumán	San Javier, Tucumán
río grande	Río Grande
san miguel de tucumán	San Miguel de Tucumán
paraná	Paraná
gonzález catán	González Catán
josé maría ezeiza	José María Ezeiza
san nicolás de los arroyos	San Nicolás de los Arroyos
ramos mejía	Ramos Mejía
gualeguaychú	Gualeguaychú
morón	Morón
río gallegos	Río Gallegos
villa domínico	Villa Domínico
josé mármol	José Mármol
gobernador gálvez	Gobernador Gálvez
concepción del uruguay	Concepción del Uruguay
sarandí	Sarandí
chajarí	Chajarí
cutral-có	Cutral-Có
san martín de los andes	San Martín de los Andes
general martín miguel de güemes	General Martín Miguel de Güemes
federación	Federación
fray luis a. beltrán	Fray Luis A. Beltrán
añatuya	Añatuya
mar de ajó	Mar de Ajó
frías	Frías
puerto san martín	Puerto San Martín
junín de los andes	Junín de los Andes
río colorado	Río Colorado
yacimiento río turbio	Yacimiento Río Turbio
jesús nazareno	Jesús Nazareno
san julián	San Julián
carhué	Carhué
general fernández oro	General Fernández Oro
buenos aires, general san martín	General San Martín, Buenos Aires
buenos aires, hipólito yrigoyen	Hipólito Yrigoyen, Buenos Aires
buenos aires, ituzaingó	Ituzaingó, Buenos Aires
buenos aires, junín	Junín, Buenos Aires
buenos aires, maipú	Maipú, Buenos Aires
catamarca, san josé	San José, Catamarca
catamarca, santa maría	Santa María, Catamarca
córdoba, la cruz	La Cruz, Córdoba
córdoba, san agustín	San Agustín, Córdoba
córdoba, la calera	La Calera, Córdoba
córdoba, malvinas argentinas	Malvinas Argentinas, Córdoba
córdoba, coronel moldes	Coronel Moldes, Córdoba
córdoba, las vertientes	Las Vertientes, Córdoba
córdoba, santa catalina	Santa Catalina, Córdoba
córdoba, la puerta	La Puerta, Córdoba
córdoba, pilar	Pilar, Córdoba
córdoba, san pedro	San Pedro, Córdoba
córdoba, la paz	La Paz, Córdoba
córdoba, san josé	San José, Córdoba
córdoba, san francisco	San Francisco, Córdoba
córdoba, almafuerte	Almafuerte, Córdoba
córdoba, sarmiento	Sarmiento, Córdoba
córdoba, los molinos	Los Molinos, Córdoba
córdoba, san ignacio	San Ignacio, Córdoba
córdoba, ranqueles	Ranqueles, Córdoba
córdoba, avellaneda	Avellaneda, Córdoba
córdoba, saladillo	Saladillo, Córdoba
córdoba, las palmas	Las Palmas, Córdoba
córdoba, san roque	San Roque, Córdoba
córdoba, atahona	Atahona, Córdoba
córdoba, esquina	Esquina, Córdoba
córdoba, san lorenzo	San Lorenzo, Córdoba
córdoba, san vicente	San Vicente, Córdoba
córdoba, colonia iturraspe	Colonia Iturraspe, Córdoba
córdoba, el rodeo	El Rodeo, Córdoba
corrientes, ituzaingó	Ituzaingó, Corrientes
corrientes, santo tomé	Santo Tomé, Corrientes
chaco, general san martín	General San Martín, Chaco
formosa, general güemes	General Güemes, Formosa
jujuy, hipólito yrigoyen	Hipólito Yrigoyen, Jujuy
la pampa, general san martín	General San Martín, La Pampa
la rioja, general san martín	General San Martín, La Rioja
mendoza, junín	Junín, Mendoza
mendoza, maipú	Maipú, Mendoza
mendoza, san martín	San Martín, Mendoza
misiones, san josé	San José, Misiones
misiones, santa maría	Santa María, Misiones
misiones, san martín	San Martín, Misiones
neuquén, barrancas	Barrancas, Neuquén
río negro, campo grande	Campo Grande, Río Negro
río negro, rio colorado	Rio Colorado, Río Negro
salta, general güemes	General Güemes, Salta
salta, hipólito yrigoyen	Hipólito Yrigoyen, Salta
santa fe, santo tomé	Santo Tomé, Santa Fe
santa fe, ituzaingó	Ituzaingó, Santa Fe
santa fe, san agustín	San Agustín, Santa Fe
tucumán, san ignacio	San Ignacio, Tucumán
tucumán, rio colorado	Rio Colorado, Tucumán
tucumán, santa ana	Santa Ana, Tucumán
tucumán, atahona	Atahona, Tucumán
tucumán, buena vista	Buena Vista, Tucumán
tucumán, la esperanza	La Esperanza, Tucumán
tucumán, san javier	San Javier, Tucumán
general san martín (buenos aires)	General San Martín, Buenos Aires
hipólito yrigoyen (buenos aires)	Hipólito Yrigoyen, Buenos Aires
ituzaingó (buenos aires)	Ituzaingó, Buenos Aires
junín (buenos aires)	Junín, Buenos Aires
maipú (buenos aires)	Maipú, Buenos Aires
san josé (catamarca)	San José, Catamarca
santa maría (catamarca)	Santa María, Catamarca
la cruz (córdoba)	La Cruz, Córdoba
san agustín (córdoba)	San Agustín, Córdoba
la calera (córdoba)	La Calera, Córdoba
malvinas argentinas (córdoba)	Malvinas Argentinas, Córdoba
coronel moldes (córdoba)	Coronel Moldes, Córdoba
las vertientes (córdoba)	Las Vertientes, Córdoba
santa catalina (córdoba)	Santa Catalina, Córdoba
la puerta (córdoba)	La Puerta, Córdoba
pilar (córdoba)	Pilar, Córdoba
san pedro (córdoba)	San Pedro, Córdoba
la paz (córdoba)	La Paz, Córdoba
san josé (córdoba)	San José, Córdoba
san francisco (córdoba)	San Francisco, Córdoba
almafuerte (córdoba)	Almafuerte, Córdoba
sarmiento (córdoba)	Sarmiento, Córdoba
los molinos (córdoba)	Los Molinos, Córdoba
san ignacio (córdoba)	San Ignacio, Córdoba
ranqueles (córdoba)	Ranqueles, Córdoba
avellaneda (córdoba)	Avellaneda, Córdoba
saladillo (córdoba)	Saladillo, Córdoba
las palmas (córdoba)	Las Palmas, Córdoba
san roque (córdoba)	San Roque, Córdoba
atahona (córdoba)	Atahona, Córdoba
esquina (córdoba)	Esquina, Córdoba
san lorenzo (córdoba)	San Lorenzo, Córdoba
san vicente (córdoba)	San Vicente, Córdoba
colonia iturraspe (córdoba)	Colonia Iturraspe, Córdoba
el rodeo (córdoba)	El Rodeo, Córdoba
ituzaingó (corrientes)	Ituzaingó, Corrientes
santo tomé (corrientes)	Santo Tomé, Corrientes
general san martín (chaco)	General San Martín, Chaco
general güemes (formosa)	General Güemes, Formosa
hipólito yrigoyen (jujuy)	Hipólito Yrigoyen, Jujuy
general san martín (la pampa)	General San Martín, La Pampa
general san martín (la rioja)	General San Martín, La Rioja
junín (mendoza)	Junín, Mendoza
maipú (mendoza)	Maipú, Mendoza
san martín (mendoza)	San Martín, Mendoza
san josé (misiones)	San José, Misiones
santa maría (misiones)	Santa María, Misiones
san martín (misiones)	San Martín, Misiones
barrancas (neuquén)	Barrancas, Neuquén
campo grande (río negro)	Campo Grande, Río Negro
rio colorado (río negro)	Rio Colorado, Río Negro
general güemes (salta)	General Güemes, Salta
hipólito yrigoyen (salta)	Hipólito Yrigoyen, Salta
santo tomé (santa fe)	Santo Tomé, Santa Fe
ituzaingó (santa fe)	Ituzaingó, Santa Fe
san agustín (santa fe)	San Agustín, Santa Fe
san ignacio (tucumán)	San Ignacio, Tucumán
rio colorado (tucumán)	Rio Colorado, Tucumán
santa ana (tucumán)	Santa Ana, Tucumán
atahona (tucumán)	Atahona, Tucumán
buena vista (tucumán)	Buena Vista, Tucumán
la esperanza (tucumán)	La Esperanza, Tucumán
san javier (tucumán)	San Javier, Tucumán
general san martín(buenos aires)	General San Martín, Buenos Aires
hipólito yrigoyen(buenos aires)	Hipólito Yrigoyen, Buenos Aires
ituzaingó(buenos aires)	Ituzaingó, Buenos Aires
junín(buenos aires)	Junín, Buenos Aires
maipú(buenos aires)	Maipú, Buenos Aires
san josé(catamarca)	San José, Catamarca
santa maría(catamarca)	Santa María, Catamarca
la cruz(córdoba)	La Cruz, Córdoba
san agustín(córdoba)	San Agustín, Córdoba
la calera(córdoba)	La Calera, Córdoba
malvinas argentinas(córdoba)	Malvinas Argentinas, Córdoba
coronel moldes(córdoba)	Coronel Moldes, Córdoba
las vertientes(córdoba)	Las Vertientes, Córdoba
santa catalina(córdoba)	Santa Catalina, Córdoba
la puerta(córdoba)	La Puerta, Córdoba
pilar(córdoba)	Pilar, Córdoba
san pedro(córdoba)	San Pedro, Córdoba
la paz(córdoba)	La Paz, Córdoba
san josé(córdoba)	San José, Córdoba
san francisco(córdoba)	San Francisco, Córdoba
almafuerte(córdoba)	Almafuerte, Córdoba
sarmiento(córdoba)	Sarmiento, Córdoba
los molinos(córdoba)	Los Molinos, Córdoba
san ignacio(córdoba)	San Ignacio, Córdoba
ranqueles(córdoba)	Ranqueles, Córdoba
avellaneda(córdoba)	Avellaneda, Córdoba
saladillo(córdoba)	Saladillo, Córdoba
las palmas(córdoba)	Las Palmas, Córdoba
san roque(córdoba)	San Roque, Córdoba
atahona(córdoba)	Atahona, Córdoba
esquina(córdoba)	Esquina, Córdoba
san lorenzo(córdoba)	San Lorenzo, Córdoba
san vicente(córdoba)	San Vicente, Córdoba
colonia iturraspe(córdoba)	Colonia Iturraspe, Córdoba
el rodeo(córdoba)	El Rodeo, Córdoba
ituzaingó(corrientes)	Ituzaingó, Corrientes
santo tomé(corrientes)	Santo Tomé, Corrientes
general san martín(chaco)	General San Martín, Chaco
general güemes(formosa)	General Güemes, Formosa
hipólito yrigoyen(jujuy)	Hipólito Yrigoyen, Jujuy
general san martín(la pampa)	General San Martín, La Pampa
general san martín(la rioja)	General San Martín, La Rioja
junín(mendoza)	Junín, Mendoza
maipú(mendoza)	Maipú, Mendoza
san martín(mendoza)	San Martín, Mendoza
san josé(misiones)	San José, Misiones
santa maría(misiones)	Santa María, Misiones
san martín(misiones)	San Martín, Misiones
barrancas(neuquén)	Barrancas, Neuquén
campo grande(río negro)	Campo Grande, Río Negro
rio colorado(río negro)	Rio Colorado, Río Negro
general güemes(salta)	General Güemes, Salta
hipólito yrigoyen(salta)	Hipólito Yrigoyen, Salta
santo tomé(santa fe)	Santo Tomé, Santa Fe
ituzaingó(santa fe)	Ituzaingó, Santa Fe
san agustín(santa fe)	San Agustín, Santa Fe
san ignacio(tucumán)	San Ignacio, Tucumán
rio colorado(tucumán)	Rio Colorado, Tucumán
santa ana(tucumán)	Santa Ana, Tucumán
atahona(tucumán)	Atahona, Tucumán
buena vista(tucumán)	Buena Vista, Tucumán
la esperanza(tucumán)	La Esperanza, Tucumán
san javier(tucumán)	San Javier, Tucumán
las mulitas	Las Mulitas
gobernador racedo	Gobernador Racedo
ñancay	Ñancay
distrito sauce	Distrito Sauce
colonia cerrito	Colonia Cerrito
hoyón	Hoyón
juanillo	Juanillo
yuchán	Yuchán
punta pozo	Punta Pozo
caspi corral	Caspi Corral
villa brana	Villa Brana
san vicente, santiago del estero	San Vicente, Santiago del Estero
granadero gatica	Granadero Gatica
atoj pozo	Atoj Pozo
el aibé	El Aibé
huachana	Huachana
vaca human	Vaca Human
sotelo	Sotelo
la nena - la simona	La Nena - La Simona
negra muerta	Negra Muerta
santo domingo, santiago del estero	Santo Domingo, Santiago del Estero
la paliza	La Paliza
tres cruces, santiago del estero	Tres Cruces, Santiago del Estero
sumamao	Sumamao
ahí veremos	Ahí Veremos
sol de mayo	Sol de Mayo
san benito, santiago del estero	San Benito, Santiago del Estero
amamá	Amamá
vaca huañuna	Vaca Huañuna
melero	Melero
los ovejeros	Los Ovejeros
el deán	El Deán
libertad, santiago del estero	Libertad, Santiago del Estero
abra grande	Abra Grande
san antonio - roldán	San Antonio - Roldán
el sauzal	El Sauzal
remes	Remes
santa catalina, santiago del estero	Santa Catalina, Santiago del Estero
villa nueva, santiago del estero	Villa Nueva, Santiago del Estero
vuelta de la barranca	Vuelta de la Barranca
campo grande, santiago del estero	Campo Grande, Santiago del Estero
sauce solo	Sauce Solo
amicha	Amicha
villa hipólita	Villa Hipólita
los romanos - santo domingo	Los Romanos - Santo Domingo
villa mercedes, santiago del estero	Villa Mercedes, Santiago del Estero
tío pozo	Tío Pozo
lescano	Lescano
acos - pozo de arbolito	Acos - Pozo de Arbolito
santa maría, santiago del estero	Santa María, Santiago del Estero
malbrán	Malbrán
argentina	Argentina
casares	Casares
pinto	Pinto
sachajoy	Sachajoy
donadeu	Donadeu
campo gallo	Campo Gallo
santos lugares	Santos Lugares
villa atamisqui	Villa Atamisqui
estación atamisqui	Estación Atamisqui
medellín	Medellín
lugones	Lugones
herrera, santiago del estero	Herrera, Santiago del Estero
villa mailín	Villa Mailín
real sayana	Real Sayana
colonia dora	Colonia Dora
icaño, santiago del estero	Icaño, Santiago del Estero
cañada escobar	Cañada Escobar
los quiroga	Los Quiroga
la aurora	La Aurora
clodomira	Clodomira
ardiles	Ardiles
antajé	Antajé
chaupi pozo	Chaupi Pozo
san ramón - la dársena	San Ramón - La Dársena
la banda, santiago del estero	La Banda, Santiago del Estero
estación simbolar	Estación Simbolar
guardia escolta	Guardia Escolta
cuatro bocas	Cuatro Bocas
bandera	Bandera
fortín inca	Fortín Inca
san pedro, santiago del estero	San Pedro, Santiago del Estero
villa zanjón	Villa Zanjón
los pirpintos	Los Pirpintos
san josé del boquerón	San José del Boquerón
pampa de los guanacos	Pampa de los Guanacos
monte quemado, santiago del estero	Monte Quemado, Santiago del Estero
el caburé	El Caburé
tapso, santiago del estero	Tapso, Santiago del Estero
laprida, santiago del estero	Laprida, Santiago del Estero
frías, santiago del estero	Frías, Santiago del Estero
villa la punta	Villa La Punta
choya	Choya
bandera bajada	Bandera Bajada
la invernada	La Invernada
la cañada	La Cañada
colonia san juan	Colonia San Juan
villa figueroa	Villa Figueroa
los juríes	Los Juríes
averías	Averías
tacañitas	Tacañitas
tomás young	Tomás Young
añatuya, santiago del estero	Añatuya, Santiago del Estero
lavalle, santiago del estero	Lavalle, Santiago del Estero
san pedro de guasayán	San Pedro de Guasayán
gramilla	Gramilla
el charco	El Charco
el bobadal	El Bobadal
el arenal	El Arenal
pozo hondo	Pozo Hondo
suncho corral	Suncho Corral
vilelas	Vilelas
el cuadrado	El Cuadrado
el colorado, santiago del estero	El Colorado, Santiago del Estero
matará	Matará
loreto, santiago del estero	Loreto, Santiago del Estero
villa unión	Villa Unión
otumpa	Otumpa
lilo viejo - patay	Lilo Viejo - Patay
las tinajas	Las Tinajas
weisburd	Weisburd
quimilí	Quimilí
tintina	Tintina
villa ojo de agua	Villa Ojo de Agua
sol de julio	Sol de Julio
rapelli	Rapelli
nueva esperanza	Nueva Esperanza
pozo betbeder	Pozo Betbeder
las delicias	Las Delicias
el mojón	El Mojón
ramírez de velazco	Ramírez de Velazco
beltrán	Beltrán
sumanpa	Sumanpa
pozuelos	Pozuelos
vinará	Vinará
los núñez	Los Núñez
colonia tinco	Colonia Tinco
villa río hondo	Villa Río Hondo
termas de río hondo	Termas de Río Hondo
selva	Selva
colonia alpina	Colonia Alpina
palo negro	Palo Negro
fernández	Fernández
vilmer	Vilmer
colonia el simbolar	Colonia El Simbolar
forres	Forres
los telares	Los Telares
villa salavina	Villa Salavina
chilca juliana	Chilca Juliana
brea pozo	Brea Pozo
estación robles	Estación Robles
taboada	Taboada
garza	Garza
villa silípica	Villa Silípica
árraga	Árraga
nueva francia	Nueva Francia
villa matoque	Villa Matoque
guampacha	Guampacha
doña luisa	Doña Luisa
villa guasayán	Villa Guasayán
pozo del toba	Pozo del Toba
quebracho coto	Quebracho Coto
villa robles	Villa Robles
sabagasta	Sabagasta
manogasta	Manogasta
arroyo barú	Arroyo Barú
colón, entre ríos	Colón, Entre Ríos
hambis	Hambis
hocker	Hocker
la clarita	La Clarita
pueblo cazes	Pueblo Cazes
pueblo liebig	Pueblo Liebig
san josé, entre ríos	San José, Entre Ríos
ubajay	Ubajay
villa elisa, entre ríos	Villa Elisa, Entre Ríos
estancia grande, entre ríos	Estancia Grande, Entre Ríos
clodomiro ledesma	Clodomiro Ledesma
colonia ayuí	Colonia Ayuí
general roca, entre ríos	General Roca, Entre Ríos
concordia, entre ríos	Concordia, Entre Ríos
estación yeruá	Estación Yeruá
estación yuquerí	Estación Yuquerí
la criolla, entre ríos	La Criolla, Entre Ríos
los charrúas	Los Charrúas
nueva escocia	Nueva Escocia
pedernal	Pedernal
puerto yeruá	Puerto Yeruá
aldea brasilera	Aldea Brasilera
aldea grapschental	Aldea Grapschental
aldea protestante	Aldea Protestante
aldea salto	Aldea Salto
general alvear, entre ríos	General Alvear, Entre Ríos
aldea spatzenkutter	Aldea Spatzenkutter
aldea valle maría	Aldea Valle María
colonia ensayo	Colonia Ensayo
diamante	Diamante
estación camps	Estación Camps
general ramírez	General Ramírez
las cuevas	Las Cuevas
villa libertador san martín	Villa Libertador San Martín
chajarí, entre ríos	Chajarí, Entre Ríos
colonia alemana	Colonia Alemana
colonia la argentina	Colonia La Argentina
san ramón	San Ramón
federación, entre ríos	Federación, Entre Ríos
los conquistadores	Los Conquistadores
san jaime de la frontera	San Jaime de la Frontera
san pedro, entre ríos	San Pedro, Entre Ríos
santa ana, entre ríos	Santa Ana, Entre Ríos
villa del rosario, entre ríos	Villa del Rosario, Entre Ríos
conscripto bernardi	Conscripto Bernardi
el cimarrón	El Cimarrón
federal	Federal
nueva vizcaya	Nueva Vizcaya
sauce de luna	Sauce de Luna
san josé de feliciano	San José de Feliciano
san víctor	San Víctor
aldea asunción	Aldea Asunción
estación lazo	Estación Lazo
general galarza	General Galarza
gualeguay, entre ríos	Gualeguay, Entre Ríos
aldea san antonio	Aldea San Antonio
aldea san juan	Aldea San Juan
enrique carbó	Enrique Carbó
estación escriña	Estación Escriña
estación parera	Estación Parera
general almada	General Almada
gilbert	Gilbert
gualeguaychú, entre ríos	Gualeguaychú, Entre Ríos
irazusta	Irazusta
larroque	Larroque
pastor britos	Pastor Britos
pueblo general belgrano	Pueblo General Belgrano
urdinarrain	Urdinarrain
ceibas	Ceibas
ibicuy	Ibicuy
médanos	Médanos
villa paranacito, entre ríos	Villa Paranacito, Entre Ríos
alcaraz	Alcaraz
bovril	Bovril
colonia avigdor	Colonia Avigdor
el solar	El Solar
la paz, entre ríos	La Paz, Entre Ríos
piedras blancas	Piedras Blancas
san gustavo	San Gustavo
santa elena, entre ríos	Santa Elena, Entre Ríos
sir leonard	Sir Leonard
villa aranguren	Villa Aranguren
betbeder	Betbeder
don cristóbal ii	Don Cristóbal II
febre	Febre
villa sabá z. hernández	Villa Sabá Z. Hernández
lucas gonzález	Lucas González
nogoyá	Nogoyá
xx de septiembre	XX de Septiembre
aldea maría luisa	Aldea María Luisa
crespo	Crespo
aldea san rafael	Aldea San Rafael
aldea santa maría, entre ríos	Aldea Santa María, Entre Ríos
aldea santa rosa	Aldea Santa Rosa
cerrito	Cerrito
colonia avellaneda	Colonia Avellaneda
colonia crespo	Colonia Crespo
el palenque	El Palenque
el pingo	El Pingo
quebracho	Quebracho
hasenkamp	Hasenkamp
hernandarias	Hernandarias
la picada	La Picada
paraje las tunas	Paraje Las Tunas
maría grande	María Grande
oro verde	Oro Verde
paraná, entre ríos	Paraná, Entre Ríos
las garzas, entre ríos	Las Garzas, Entre Ríos
pueblo brugo	Pueblo Brugo
puerto curtiembre	Puerto Curtiembre
san benito, entre ríos	San Benito, Entre Ríos
sauce montrull	Sauce Montrull
sauce pinto	Sauce Pinto
seguí	Seguí
estación sosa	Estación Sosa
tabossi	Tabossi
tezanos pinto	Tezanos Pinto
viale	Viale
villa fontana, entre ríos	Villa Fontana, Entre Ríos
gobernador etchevehere	Gobernador Etchevehere
villa urquiza	Villa Urquiza
general campos, entre ríos	General Campos, Entre Ríos
san salvador, entre ríos	San Salvador, Entre Ríos
altamirano sur	Altamirano Sur
durazno	Durazno
arroyo cle	Arroyo Cle
gobernador echagüe	Gobernador Echagüe
gobernador mansilla	Gobernador Mansilla
gobernador sola	Gobernador Sola
guardamonte	Guardamonte
las guachas	Las Guachas
maciá	Maciá
rosario del tala, entre ríos	Rosario del Tala, Entre Ríos
basavilbaso	Basavilbaso
caseros, entre ríos	Caseros, Entre Ríos
colonia elía	Colonia Elía
concepción del uruguay, entre ríos	Concepción del Uruguay, Entre Ríos
herrera, entre ríos	Herrera, Entre Ríos
las moscas	Las Moscas
líbaros	Líbaros
1º de mayo	1º de Mayo
pronunciamiento	Pronunciamiento
rocamora	Rocamora
santa anita	Santa Anita
villa mantero	Villa Mantero
san justo, entre ríos	San Justo, Entre Ríos
san marcial	San Marcial
antelo	Antelo
molino doll	Molino Doll
victoria, entre ríos	Victoria, Entre Ríos
estación raíces	Estación Raíces
ingeniero sajaroff	Ingeniero Sajaroff
jubileo	Jubileo
paso de la laguna	Paso de La Laguna
villa clara	Villa Clara
villa domínguez	Villa Domínguez
villaguay, entre ríos	Villaguay, Entre Ríos
albardón	Albardón
angaco	Angaco
calingasta	Calingasta
caucete	Caucete
chimbas	Chimbas
iglesia	Iglesia
jáchal	Jáchal
9 de julio, san juan	9 de Julio, San Juan
pocito	Pocito
rawson, san juan	Rawson, San Juan
rivadavia, san juan	Rivadavia, San Juan
san martín, san juan	San Martín, San Juan
santa lucía, san juan	Santa Lucía, San Juan
sarmiento, san juan	Sarmiento, San Juan
ullum	Ullum
valle fértil	Valle Fértil
25 de mayo, san juan	25 de Mayo, San Juan
zonda	Zonda
el redomón	El Redomón
costa grande	Costa Grande
isletas	Isletas
san roque, entre ríos	San Roque, Entre Ríos
gualeguaycito	Gualeguaycito
colonia santa maría y las margaritas	Colonia Santa María y Las Margaritas
paraje guayaquil	Paraje Guayaquil
paso duarte	Paso Duarte
arroyo del medio, entre ríos	Arroyo del Medio, Entre Ríos
arroyo las tunas	Arroyo Las Tunas
banderas	Banderas
loma limpia	Loma Limpia
laguna benítez	Laguna Benítez
la esmeralda	La Esmeralda
mulas grandes	Mulas Grandes
la hierra	La Hierra
la verbena	La Verbena
gonzález calderón	González Calderón
monte redondo	Monte Redondo
punta del monte	Punta del Monte
cuchilla redonda	Cuchilla Redonda
costa uruguay norte	Costa Uruguay Norte
costa uruguay sur	Costa Uruguay Sur
yeso oeste	Yeso Oeste
distrito talitas	Distrito Talitas
las mercedes	Las Mercedes
perdices	Perdices
rincón del cinto	Rincón del Cinto
rincón del gato	Rincón del Gato
alcaraz norte	Alcaraz Norte
alcaraz sur	Alcaraz Sur
yacaré	Yacaré
puerto algarrobo	Puerto Algarrobo
estaquitas	Estaquitas
colonia carrasco	Colonia Carrasco
colonia oficial nº 3 y 14	Colonia Oficial Nº 3 y 14
colonia viraró	Colonia Viraró
la providencia	La Providencia
las toscas, entre ríos	Las Toscas, Entre Ríos
ombú	Ombú
picada berón	Picada Berón
san ramírez	San Ramírez
aldea san miguel	Aldea San Miguel
crucesitas octava	Crucesitas Octava
crucesitas séptima	Crucesitas Séptima
crucesitas tercera	Crucesitas Tercera
justo josé de urquiza	Justo José de Urquiza
laurencena	Laurencena
aldea eigenfeld	Aldea Eigenfeld
antonio tomás	Antonio Tomás
arroyo burgos	Arroyo Burgos
arroyo maturrango	Arroyo Maturrango
arroyo palo seco	Arroyo Palo Seco
santa luisa	Santa Luisa
paso de las piedras	Paso de las Piedras
colonia celina	Colonia Celina
colonia merou	Colonia Merou
colonia reffino	Colonia Reffino
distrito tala	Distrito Tala
espinillo norte	Espinillo Norte
paso de la arena	Paso de la Arena
colonia baylina	Colonia Baylina
walter moss	Walter Moss
san ernesto	San Ernesto
la ollita	La Ollita
sauce sur	Sauce Sur
arroyo gená	Arroyo Gená
comuna tala	Comuna Tala
san cipriano	San Cipriano
chilcas	Chilcas
hinojal	Hinojal
laguna del pescado	Laguna del Pescado
montoya	Montoya
rincón de nogoyá	Rincón de Nogoyá
rincón del doll	Rincón del Doll
raíces oeste	Raíces Oeste
lucas norte	Lucas Norte
colonia adivino	Colonia Adivino
mojones sur	Mojones Sur
mojones norte	Mojones Norte
paraje los algarrobos	Paraje Los Algarrobos
la florida	La Florida
la fraternidad y santa juana	La Fraternidad y Santa Juana
el gramiyal	El Gramiyal
santa lucía, entre ríos	Santa Lucía, Entre Ríos
islas las lechiguanas	Islas Las Lechiguanas
el quebracho	El Quebracho
saucecito	Saucecito
maría grande 2º	María Grande 2º
lucas sur primero	Lucas Sur Primero
lucas sur segundo	Lucas Sur Segundo
colonia san anselmo y aledañas	Colonia San Anselmo y Aledañas
colonia tunas	Colonia Tunas
distrito diego lópez	Distrito Diego López
distrito chañar	Distrito Chañar
distrito cuarto	Distrito Cuarto
distrito primero	Distrito Primero
distrito quinto	Distrito Quinto
costa san antonio	Costa San Antonio
colonia oficial n° 13	Colonia Oficial N° 13
distrito chiqueros	Distrito Chiqueros
don cristóbal i	Don Cristóbal I
arroyo corralito	Arroyo Corralito
colonia oficial nº 5	Colonia Oficial Nº 5
distrito pajonal	Distrito Pajonal
distrito sexto	Distrito Sexto
comandante luis piedra buena, santa cruz	Comandante Luis Piedra Buena, Santa Cruz
puerto santa cruz	Puerto Santa Cruz
jaramillo y fitz roy	Jaramillo y Fitz Roy
cañadón seco	Cañadón Seco
las heras, santa cruz	Las Heras, Santa Cruz
puerto deseado, santa cruz	Puerto Deseado, Santa Cruz
pico truncado, santa cruz	Pico Truncado, Santa Cruz
nuestra señora de los dolores de koluel kaike	Nuestra Señora de los Dolores de Koluel Kaike
caleta olivia, santa cruz	Caleta Olivia, Santa Cruz
río turbio	Río Turbio
28 de noviembre	28 de Noviembre
río gallegos, santa cruz	Río Gallegos, Santa Cruz
el chaltén	El Chaltén
el calafate, santa cruz	El Calafate, Santa Cruz
tres lagos	Tres Lagos
los antiguos	Los Antiguos
perito moreno, santa cruz	Perito Moreno, Santa Cruz
puerto san julián	Puerto San Julián
gobernador gregores, santa cruz	Gobernador Gregores, Santa Cruz
lago posadas	Lago Posadas
el cruce	El Cruce
la noria	La Noria
kilómetro 49	Kilómetro 49
san miguel, entre ríos	San Miguel, Entre Ríos
nancay	Ñancay
hoyon	Hoyón
yuchan	Yuchán
el aibe	El Aibé
ahi veremos	Ahí Veremos
amama	Amamá
vaca huanuna	Vaca Huañuna
el dean	El Deán
san antonio - roldan	San Antonio - Roldán
villa hipolita	Villa Hipólita
tio pozo	Tío Pozo
santa maria, santiago del estero	Santa María, Santiago del Estero
malbran	Malbrán
estacion atamisqui	Estación Atamisqui
medellin	Medellín
villa mailin	Villa Mailín
icano, santiago del estero	Icaño, Santiago del Estero
canada escobar	Cañada Escobar
antaje	Antajé
san ramon - la darsena	San Ramón - La Dársena
estacion simbolar	Estación Simbolar
fortin inca	Fortín Inca
villa zanjon	Villa Zanjón
san jose del boqueron	San José del Boquerón
el cabure	El Caburé
frias, santiago del estero	Frías, Santiago del Estero
la canada	La Cañada
los juries	Los Juríes
averias	Averías
tacanitas	Tacañitas
tomas young	Tomás Young
anatuya, santiago del estero	Añatuya, Santiago del Estero
san pedro de guasayan	San Pedro de Guasayán
matara	Matará
villa union	Villa Unión
quimili	Quimilí
ramirez de velazco	Ramírez de Velazco
beltran	Beltrán
vinara	Vinará
los nunez	Los Núñez
villa rio hondo	Villa Río Hondo
termas de rio hondo	Termas de Río Hondo
fernandez	Fernández
estacion robles	Estación Robles
villa silipica	Villa Silípica
arraga	Árraga
dona luisa	Doña Luisa
villa guasayan	Villa Guasayán
arroyo baru	Arroyo Barú
colon, entre rios	Colón, Entre Ríos
san jose, entre rios	San José, Entre Ríos
villa elisa, entre rios	Villa Elisa, Entre Ríos
estancia grande, entre rios	Estancia Grande, Entre Ríos
colonia ayui	Colonia Ayuí
general roca, entre rios	General Roca, Entre Ríos
concordia, entre rios	Concordia, Entre Ríos
estacion yerua	Estación Yeruá
estacion yuqueri	Estación Yuquerí
la criolla, entre rios	La Criolla, Entre Ríos
los charruas	Los Charrúas
puerto yerua	Puerto Yeruá
general alvear, entre rios	General Alvear, Entre Ríos
aldea valle maria	Aldea Valle María
estacion camps	Estación Camps
general ramirez	General Ramírez
villa libertador san martin	Villa Libertador San Martín
chajari, entre rios	Chajarí, Entre Ríos
san ramon	San Ramón
federacion, entre rios	Federación, Entre Ríos
san pedro, entre rios	San Pedro, Entre Ríos
santa ana, entre rios	Santa Ana, Entre Ríos
villa del rosario, entre rios	Villa del Rosario, Entre Ríos
el cimarron	El Cimarrón
san jose de feliciano	San José de Feliciano
san victor	San Víctor
aldea asuncion	Aldea Asunción
estacion lazo	Estación Lazo
gualeguay, entre rios	Gualeguay, Entre Ríos
enrique carbo	Enrique Carbó
estacion escrina	Estación Escriña
estacion parera	Estación Parera
gualeguaychu, entre rios	Gualeguaychú, Entre Ríos
medanos	Médanos
villa paranacito, entre rios	Villa Paranacito, Entre Ríos
la paz, entre rios	La Paz, Entre Ríos
santa elena, entre rios	Santa Elena, Entre Ríos
don cristobal ii	Don Cristóbal II
villa saba z. hernandez	Villa Sabá Z. Hernández
lucas gonzalez	Lucas González
nogoya	Nogoyá
aldea maria luisa	Aldea María Luisa
aldea santa maria, entre rios	Aldea Santa María, Entre Ríos
maria grande	María Grande
parana, entre rios	Paraná, Entre Ríos
las garzas, entre rios	Las Garzas, Entre Ríos
san benito, entre rios	San Benito, Entre Ríos
segui	Seguí
estacion sosa	Estación Sosa
villa fontana, entre rios	Villa Fontana, Entre Ríos
general campos, entre rios	General Campos, Entre Ríos
san salvador, entre rios	San Salvador, Entre Ríos
gobernador echague	Gobernador Echagüe
macia	Maciá
rosario del tala, entre rios	Rosario del Tala, Entre Ríos
caseros, entre rios	Caseros, Entre Ríos
colonia elia	Colonia Elía
concepcion del uruguay, entre rios	Concepción del Uruguay, Entre Ríos
herrera, entre rios	Herrera, Entre Ríos
libaros	Líbaros
1 de mayo	1º de Mayo
san justo, entre rios	San Justo, Entre Ríos
victoria, entre rios	Victoria, Entre Ríos
estacion raices	Estación Raíces
villa dominguez	Villa Domínguez
villaguay, entre rios	Villaguay, Entre Ríos
albardon	Albardón
jachal	Jáchal
san martin, san juan	San Martín, San Juan
santa lucia, san juan	Santa Lucía, San Juan
valle fertil	Valle Fértil
el redomon	El Redomón
san roque, entre rios	San Roque, Entre Ríos
colonia santa maria y las margaritas	Colonia Santa María y Las Margaritas
arroyo del medio, entre rios	Arroyo del Medio, Entre Ríos
laguna benitez	Laguna Benítez
gonzalez calderon	González Calderón
rincon del cinto	Rincón del Cinto
rincon del gato	Rincón del Gato
yacare	Yacaré
colonia oficial n 3 y 14	Colonia Oficial Nº 3 y 14
colonia viraro	Colonia Viraró
las toscas, entre rios	Las Toscas, Entre Ríos
ombu	Ombú
picada beron	Picada Berón
san ramirez	San Ramírez
crucesitas septima	Crucesitas Séptima
justo jose de urquiza	Justo José de Urquiza
antonio tomas	Antonio Tomás
arroyo gena	Arroyo Gená
rincon de nogoya	Rincón de Nogoyá
rincon del doll	Rincón del Doll
raices oeste	Raíces Oeste
santa lucia, entre rios	Santa Lucía, Entre Ríos
maria grande 2	María Grande 2º
colonia san anselmo y aledanas	Colonia San Anselmo y Aledañas
distrito diego lopez	Distrito Diego López
distrito chanar	Distrito Chañar
colonia oficial n 13	Colonia Oficial N° 13
don cristobal i	Don Cristóbal I
colonia oficial n 5	Colonia Oficial Nº 5
canadon seco	Cañadón Seco
nuestra senora de los dolores de koluel kaike	Nuestra Señora de los Dolores de Koluel Kaike
rio turbio	Río Turbio
rio gallegos, santa cruz	Río Gallegos, Santa Cruz
el chalten	El Chaltén
puerto san julian	Puerto San Julián
kilometro 49	Kilómetro 49
san miguel, entre rios	San Miguel, Entre Ríos
ñancay	Ñancay
hoyón	Hoyón
yuchán	Yuchán
el aibé	El Aibé
ahí veremos	Ahí Veremos
amamá	Amamá
vaca huañuna	Vaca Huañuna
el deán	El Deán
san antonio - roldán	San Antonio - Roldán
villa hipólita	Villa Hipólita
tío pozo	Tío Pozo
santa maría, santiago del estero	Santa María, Santiago del Estero
malbrán	Malbrán
estación atamisqui	Estación Atamisqui
medellín	Medellín
villa mailín	Villa Mailín
icaño, santiago del estero	Icaño, Santiago del Estero
cañada escobar	Cañada Escobar
antajé	Antajé
san ramón - la dársena	San Ramón - La Dársena
estación simbolar	Estación Simbolar
fortín inca	Fortín Inca
villa zanjón	Villa Zanjón
san josé del boquerón	San José del Boquerón
el caburé	El Caburé
frías, santiago del estero	Frías, Santiago del Estero
la cañada	La Cañada
los juríes	Los Juríes
averías	Averías
tacañitas	Tacañitas
tomás young	Tomás Young
añatuya, santiago del estero	Añatuya, Santiago del Estero
san pedro de guasayán	San Pedro de Guasayán
matará	Matará
villa unión	Villa Unión
quimilí	Quimilí
el mojón	El Mojón
ramírez de velazco	Ramírez de Velazco
beltrán	Beltrán
vinará	Vinará
los núñez	Los Núñez
villa río hondo	Villa Río Hondo
termas de río hondo	Termas de Río Hondo
fernández	Fernández
estación robles	Estación Robles
villa silípica	Villa Silípica
árraga	Árraga
doña luisa	Doña Luisa
villa guasayán	Villa Guasayán
arroyo barú	Arroyo Barú
colón, entre ríos	Colón, Entre Ríos
san josé, entre ríos	San José, Entre Ríos
villa elisa, entre ríos	Villa Elisa, Entre Ríos
estancia grande, entre ríos	Estancia Grande, Entre Ríos
colonia ayuí	Colonia Ayuí
general roca, entre ríos	General Roca, Entre Ríos
concordia, entre ríos	Concordia, Entre Ríos
estación yeruá	Estación Yeruá
estación yuquerí	Estación Yuquerí
la criolla, entre ríos	La Criolla, Entre Ríos
los charrúas	Los Charrúas
puerto yeruá	Puerto Yeruá
general alvear, entre ríos	General Alvear, Entre Ríos
aldea valle maría	Aldea Valle María
estación camps	Estación Camps
general ramírez	General Ramírez
villa libertador san martín	Villa Libertador San Martín
chajarí, entre ríos	Chajarí, Entre Ríos
san ramón	San Ramón
federación, entre ríos	Federación, Entre Ríos
san pedro, entre ríos	San Pedro, Entre Ríos
santa ana, entre ríos	Santa Ana, Entre Ríos
villa del rosario, entre ríos	Villa del Rosario, Entre Ríos
el cimarrón	El Cimarrón
san josé de feliciano	San José de Feliciano
san víctor	San Víctor
aldea asunción	Aldea Asunción
estación lazo	Estación Lazo
gualeguay, entre ríos	Gualeguay, Entre Ríos
enrique carbó	Enrique Carbó
estación escriña	Estación Escriña
estación parera	Estación Parera
gualeguaychú, entre ríos	Gualeguaychú, Entre Ríos
médanos	Médanos
villa paranacito, entre ríos	Villa Paranacito, Entre Ríos
la paz, entre ríos	La Paz, Entre Ríos
santa elena, entre ríos	Santa Elena, Entre Ríos
don cristóbal ii	Don Cristóbal II
villa sabá z. hernández	Villa Sabá Z. Hernández
lucas gonzález	Lucas González
nogoyá	Nogoyá
aldea maría luisa	Aldea María Luisa
aldea santa maría, entre ríos	Aldea Santa María, Entre Ríos
maría grande	María Grande
paraná, entre ríos	Paraná, Entre Ríos
las garzas, entre ríos	Las Garzas, Entre Ríos
san benito, entre ríos	San Benito, Entre Ríos
seguí	Seguí
estación sosa	Estación Sosa
villa fontana, entre ríos	Villa Fontana, Entre Ríos
general campos, entre ríos	General Campos, Entre Ríos
san salvador, entre ríos	San Salvador, Entre Ríos
gobernador echagüe	Gobernador Echagüe
maciá	Maciá
rosario del tala, entre ríos	Rosario del Tala, Entre Ríos
caseros, entre ríos	Caseros, Entre Ríos
colonia elía	Colonia Elía
concepción del uruguay, entre ríos	Concepción del Uruguay, Entre Ríos
herrera, entre ríos	Herrera, Entre Ríos
líbaros	Líbaros
1o de mayo	1º de Mayo
san justo, entre ríos	San Justo, Entre Ríos
victoria, entre ríos	Victoria, Entre Ríos
estación raíces	Estación Raíces
villa domínguez	Villa Domínguez
villaguay, entre ríos	Villaguay, Entre Ríos
albardón	Albardón
jáchal	Jáchal
san martín, san juan	San Martín, San Juan
santa lucía, san juan	Santa Lucía, San Juan
valle fértil	Valle Fértil
el redomón	El Redomón
san roque, entre ríos	San Roque, Entre Ríos
colonia santa maría y las margaritas	Colonia Santa María y Las Margaritas
arroyo del medio, entre ríos	Arroyo del Medio, Entre Ríos
laguna benítez	Laguna Benítez
gonzález calderón	González Calderón
rincón del cinto	Rincón del Cinto
rincón del gato	Rincón del Gato
yacaré	Yacaré
colonia oficial no 3 y 14	Colonia Oficial Nº 3 y 14
colonia viraró	Colonia Viraró
las toscas, entre ríos	Las Toscas, Entre Ríos
ombú	Ombú
picada berón	Picada Berón
san ramírez	San Ramírez
crucesitas séptima	Crucesitas Séptima
justo josé de urquiza	Justo José de Urquiza
antonio tomás	Antonio Tomás
arroyo gená	Arroyo Gená
rincón de nogoyá	Rincón de Nogoyá
rincón del doll	Rincón del Doll
raíces oeste	Raíces Oeste
santa lucía, entre ríos	Santa Lucía, Entre Ríos
maría grande 2o	María Grande 2º
colonia san anselmo y aledañas	Colonia San Anselmo y Aledañas
distrito diego lópez	Distrito Diego López
distrito chañar	Distrito Chañar
don cristóbal i	Don Cristóbal I
colonia oficial no 5	Colonia Oficial Nº 5
cañadón seco	Cañadón Seco
nuestra señora de los dolores de koluel kaike	Nuestra Señora de los Dolores de Koluel Kaike
río turbio	Río Turbio
río gallegos, santa cruz	Río Gallegos, Santa Cruz
el chaltén	El Chaltén
puerto san julián	Puerto San Julián
kilómetro 49	Kilómetro 49
san miguel, entre ríos	San Miguel, Entre Ríos
santiago del estero, san vicente	San Vicente, Santiago del Estero
santiago del estero, santo domingo	Santo Domingo, Santiago del Estero
santiago del estero, tres cruces	Tres Cruces, Santiago del Estero
santiago del estero, san benito	San Benito, Santiago del Estero
santiago del estero, libertad	Libertad, Santiago del Estero
santiago del estero, santa catalina	Santa Catalina, Santiago del Estero
santiago del estero, villa nueva	Villa Nueva, Santiago del Estero
santiago del estero, campo grande	Campo Grande, Santiago del Estero
santiago del estero, villa mercedes	Villa Mercedes, Santiago del Estero
santiago del estero, santa maría	Santa María, Santiago del Estero
santiago del estero, herrera	Herrera, Santiago del Estero
santiago del estero, icaño	Icaño, Santiago del Estero
santiago del estero, la banda	La Banda, Santiago del Estero
santiago del estero, san pedro	San Pedro, Santiago del Estero
santiago del estero, santiago del estero	Santiago del Estero, Santiago del Estero
santiago del estero, monte quemado	Monte Quemado, Santiago del Estero
santiago del estero, tapso	Tapso, Santiago del Estero
santiago del estero, laprida	Laprida, Santiago del Estero
santiago del estero, frías	Frías, Santiago del Estero
santiago del estero, añatuya	Añatuya, Santiago del Estero
santiago del estero, lavalle	Lavalle, Santiago del Estero
santiago del estero, el colorado	El Colorado, Santiago del Estero
santiago del estero, loreto	Loreto, Santiago del Estero
entre ríos, colón	Colón, Entre Ríos
entre ríos, san josé	San José, Entre Ríos
entre ríos, villa elisa	Villa Elisa, Entre Ríos
entre ríos, estancia grande	Estancia Grande, Entre Ríos
entre ríos, general roca	General Roca, Entre Ríos
entre ríos, concordia	Concordia, Entre Ríos
entre ríos, la criolla	La Criolla, Entre Ríos
entre ríos, general alvear	General Alvear, Entre Ríos
entre ríos, chajarí	Chajarí, Entre Ríos
entre ríos, federación	Federación, Entre Ríos
entre ríos, san pedro	San Pedro, Entre Ríos
entre ríos, santa ana	Santa Ana, Entre Ríos
entre ríos, villa del rosario	Villa del Rosario, Entre Ríos
entre ríos, gualeguay	Gualeguay, Entre Ríos
entre ríos, gualeguaychú	Gualeguaychú, Entre Ríos
entre ríos, villa paranacito	Villa Paranacito, Entre Ríos
entre ríos, la paz	La Paz, Entre Ríos
entre ríos, santa elena	Santa Elena, Entre Ríos
entre ríos, aldea santa maría	Aldea Santa María, Entre Ríos
entre ríos, paraná	Paraná, Entre Ríos
entre ríos, las garzas	Las Garzas, Entre Ríos
entre ríos, san benito	San Benito, Entre Ríos
entre ríos, villa fontana	Villa Fontana, Entre Ríos
entre ríos, general campos	General Campos, Entre Ríos
entre ríos, san salvador	San Salvador, Entre Ríos
entre ríos, rosario del tala	Rosario del Tala, Entre Ríos
entre ríos, caseros	Caseros, Entre Ríos
entre ríos, concepción del uruguay	Concepción del Uruguay, Entre Ríos
entre ríos, herrera	Herrera, Entre Ríos
entre ríos, san justo	San Justo, Entre Ríos
entre ríos, victoria	Victoria, Entre Ríos
entre ríos, villaguay	Villaguay, Entre Ríos
san juan, san juan	San Juan, San Juan
san juan, 9 de julio	9 de Julio, San Juan
san juan, rawson	Rawson, San Juan
san juan, rivadavia	Rivadavia, San Juan
san juan, san martín	San Martín, San Juan
san juan, santa lucía	Santa Lucía, San Juan
san juan, sarmiento	Sarmiento, San Juan
san juan, 25 de mayo	25 de Mayo, San Juan
entre ríos, san roque	San Roque, Entre Ríos
entre ríos, arroyo del medio	Arroyo del Medio, Entre Ríos
entre ríos, las toscas	Las Toscas, Entre Ríos
entre ríos, santa lucía	Santa Lucía, Entre Ríos
santa cruz, comandante luis piedra buena	Comandante Luis Piedra Buena, Santa Cruz
santa cruz, las heras	Las Heras, Santa Cruz
santa cruz, puerto deseado	Puerto Deseado, Santa Cruz
santa cruz, pico truncado	Pico Truncado, Santa Cruz
santa cruz, caleta olivia	Caleta Olivia, Santa Cruz
santa cruz, río gallegos	Río Gallegos, Santa Cruz
santa cruz, el calafate	El Calafate, Santa Cruz
santa cruz, perito moreno	Perito Moreno, Santa Cruz
santa cruz, gobernador gregores	Gobernador Gregores, Santa Cruz
entre ríos, san miguel	San Miguel, Entre Ríos
san vicente (santiago del estero)	San Vicente, Santiago del Estero
santo domingo (santiago del estero)	Santo Domingo, Santiago del Estero
tres cruces (santiago del estero)	Tres Cruces, Santiago del Estero
san benito (santiago del estero)	San Benito, Santiago del Estero
libertad (santiago del estero)	Libertad, Santiago del Estero
santa catalina (santiago del estero)	Santa Catalina, Santiago del Estero
villa nueva (santiago del estero)	Villa Nueva, Santiago del Estero
campo grande (santiago del estero)	Campo Grande, Santiago del Estero
villa mercedes (santiago del estero)	Villa Mercedes, Santiago del Estero
santa maría (santiago del estero)	Santa María, Santiago del Estero
herrera (santiago del estero)	Herrera, Santiago del Estero
icaño (santiago del estero)	Icaño, Santiago del Estero
la banda (santiago del estero)	La Banda, Santiago del Estero
san pedro (santiago del estero)	San Pedro, Santiago del Estero
santiago del estero (santiago del estero)	Santiago del Estero, Santiago del Estero
monte quemado (santiago del estero)	Monte Quemado, Santiago del Estero
tapso (santiago del estero)	Tapso, Santiago del Estero
laprida (santiago del estero)	Laprida, Santiago del Estero
frías (santiago del estero)	Frías, Santiago del Estero
añatuya (santiago del estero)	Añatuya, Santiago del Estero
lavalle (santiago del estero)	Lavalle, Santiago del Estero
el colorado (santiago del estero)	El Colorado, Santiago del Estero
loreto (santiago del estero)	Loreto, Santiago del Estero
colón (entre ríos)	Colón, Entre Ríos
san josé (entre ríos)	San José, Entre Ríos
villa elisa (entre ríos)	Villa Elisa, Entre Ríos
estancia grande (entre ríos)	Estancia Grande, Entre Ríos
general roca (entre ríos)	General Roca, Entre Ríos
concordia (entre ríos)	Concordia, Entre Ríos
la criolla (entre ríos)	La Criolla, Entre Ríos
general alvear (entre ríos)	General Alvear, Entre Ríos
chajarí (entre ríos)	Chajarí, Entre Ríos
federación (entre ríos)	Federación, Entre Ríos
san pedro (entre ríos)	San Pedro, Entre Ríos
santa ana (entre ríos)	Santa Ana, Entre Ríos
villa del rosario (entre ríos)	Villa del Rosario, Entre Ríos
gualeguay (entre ríos)	Gualeguay, Entre Ríos
gualeguaychú (entre ríos)	Gualeguaychú, Entre Ríos
villa paranacito (entre ríos)	Villa Paranacito, Entre Ríos
la paz (entre ríos)	La Paz, Entre Ríos
santa elena (entre ríos)	Santa Elena, Entre Ríos
aldea santa maría (entre ríos)	Aldea Santa María, Entre Ríos
paraná (entre ríos)	Paraná, Entre Ríos
las garzas (entre ríos)	Las Garzas, Entre Ríos
san benito (entre ríos)	San Benito, Entre Ríos
villa fontana (entre ríos)	Villa Fontana, Entre Ríos
general campos (entre ríos)	General Campos, Entre Ríos
san salvador (entre ríos)	San Salvador, Entre Ríos
rosario del tala (entre ríos)	Rosario del Tala, Entre Ríos
caseros (entre ríos)	Caseros, Entre Ríos
concepción del uruguay (entre ríos)	Concepción del Uruguay, Entre Ríos
herrera (entre ríos)	Herrera, Entre Ríos
san justo (entre ríos)	San Justo, Entre Ríos
victoria (entre ríos)	Victoria, Entre Ríos
villaguay (entre ríos)	Villaguay, Entre Ríos
san juan (san juan)	San Juan, San Juan
9 de julio (san juan)	9 de Julio, San Juan
rawson (san juan)	Rawson, San Juan
rivadavia (san juan)	Rivadavia, San Juan
san martín (san juan)	San Martín, San Juan
santa lucía (san juan)	Santa Lucía, San Juan
sarmiento (san juan)	Sarmiento, San Juan
25 de mayo (san juan)	25 de Mayo, San Juan
san roque (entre ríos)	San Roque, Entre Ríos
arroyo del medio (entre ríos)	Arroyo del Medio, Entre Ríos
las toscas (entre ríos)	Las Toscas, Entre Ríos
santa lucía (entre ríos)	Santa Lucía, Entre Ríos
comandante luis piedra buena (santa cruz)	Comandante Luis Piedra Buena, Santa Cruz
las heras (santa cruz)	Las Heras, Santa Cruz
puerto deseado (santa cruz)	Puerto Deseado, Santa Cruz
pico truncado (santa cruz)	Pico Truncado, Santa Cruz
caleta olivia (santa cruz)	Caleta Olivia, Santa Cruz
río gallegos (santa cruz)	Río Gallegos, Santa Cruz
el calafate (santa cruz)	El Calafate, Santa Cruz
perito moreno (santa cruz)	Perito Moreno, Santa Cruz
gobernador gregores (santa cruz)	Gobernador Gregores, Santa Cruz
san miguel (entre ríos)	San Miguel, Entre Ríos
san vicente(santiago del estero)	San Vicente, Santiago del Estero
santo domingo(santiago del estero)	Santo Domingo, Santiago del Estero
tres cruces(santiago del estero)	Tres Cruces, Santiago del Estero
san benito(santiago del estero)	San Benito, Santiago del Estero
libertad(santiago del estero)	Libertad, Santiago del Estero
santa catalina(santiago del estero)	Santa Catalina, Santiago del Estero
villa nueva(santiago del estero)	Villa Nueva, Santiago del Estero
campo grande(santiago del estero)	Campo Grande, Santiago del Estero
villa mercedes(santiago del estero)	Villa Mercedes, Santiago del Estero
santa maría(santiago del estero)	Santa María, Santiago del Estero
herrera(santiago del estero)	Herrera, Santiago del Estero
icaño(santiago del estero)	Icaño, Santiago del Estero
la banda(santiago del estero)	La Banda, Santiago del Estero
san pedro(santiago del estero)	San Pedro, Santiago del Estero
santiago del estero(santiago del estero)	Santiago del Estero, Santiago del Estero
monte quemado(santiago del estero)	Monte Quemado, Santiago del Estero
tapso(santiago del estero)	Tapso, Santiago del Estero
laprida(santiago del estero)	Laprida, Santiago del Estero
frías(santiago del estero)	Frías, Santiago del Estero
añatuya(santiago del estero)	Añatuya, Santiago del Estero
lavalle(santiago del estero)	Lavalle, Santiago del Estero
el colorado(santiago del estero)	El Colorado, Santiago del Estero
loreto(santiago del estero)	Loreto, Santiago del Estero
colón(entre ríos)	Colón, Entre Ríos
san josé(entre ríos)	San José, Entre Ríos
villa elisa(entre ríos)	Villa Elisa, Entre Ríos
estancia grande(entre ríos)	Estancia Grande, Entre Ríos
general roca(entre ríos)	General Roca, Entre Ríos
concordia(entre ríos)	Concordia, Entre Ríos
la criolla(entre ríos)	La Criolla, Entre Ríos
general alvear(entre ríos)	General Alvear, Entre Ríos
chajarí(entre ríos)	Chajarí, Entre Ríos
federación(entre ríos)	Federación, Entre Ríos
san pedro(entre ríos)	San Pedro, Entre Ríos
santa ana(entre ríos)	Santa Ana, Entre Ríos
villa del rosario(entre ríos)	Villa del Rosario, Entre Ríos
gualeguay(entre ríos)	Gualeguay, Entre Ríos
gualeguaychú(entre ríos)	Gualeguaychú, Entre Ríos
villa paranacito(entre ríos)	Villa Paranacito, Entre Ríos
la paz(entre ríos)	La Paz, Entre Ríos
santa elena(entre ríos)	Santa Elena, Entre Ríos
aldea santa maría(entre ríos)	Aldea Santa María, Entre Ríos
paraná(entre ríos)	Paraná, Entre Ríos
las garzas(entre ríos)	Las Garzas, Entre Ríos
san benito(entre ríos)	San Benito, Entre Ríos
villa fontana(entre ríos)	Villa Fontana, Entre Ríos
general campos(entre ríos)	General Campos, Entre Ríos
san salvador(entre ríos)	San Salvador, Entre Ríos
rosario del tala(entre ríos)	Rosario del Tala, Entre Ríos
caseros(entre ríos)	Caseros, Entre Ríos
concepción del uruguay(entre ríos)	Concepción del Uruguay, Entre Ríos
herrera(entre ríos)	Herrera, Entre Ríos
san justo(entre ríos)	San Justo, Entre Ríos
victoria(entre ríos)	Victoria, Entre Ríos
villaguay(entre ríos)	Villaguay, Entre Ríos
san juan(san juan)	San Juan, San Juan
9 de julio(san juan)	9 de Julio, San Juan
rawson(san juan)	Rawson, San Juan
rivadavia(san juan)	Rivadavia, San Juan
san martín(san juan)	San Martín, San Juan
santa lucía(san juan)	Santa Lucía, San Juan
sarmiento(san juan)	Sarmiento, San Juan
25 de mayo(san juan)	25 de Mayo, San Juan
san roque(entre ríos)	San Roque, Entre Ríos
arroyo del medio(entre ríos)	Arroyo del Medio, Entre Ríos
las toscas(entre ríos)	Las Toscas, Entre Ríos
santa lucía(entre ríos)	Santa Lucía, Entre Ríos
comandante luis piedra buena(santa cruz)	Comandante Luis Piedra Buena, Santa Cruz
las heras(santa cruz)	Las Heras, Santa Cruz
puerto deseado(santa cruz)	Puerto Deseado, Santa Cruz
pico truncado(santa cruz)	Pico Truncado, Santa Cruz
caleta olivia(santa cruz)	Caleta Olivia, Santa Cruz
río gallegos(santa cruz)	Río Gallegos, Santa Cruz
el calafate(santa cruz)	El Calafate, Santa Cruz
perito moreno(santa cruz)	Perito Moreno, Santa Cruz
gobernador gregores(santa cruz)	Gobernador Gregores, Santa Cruz
san miguel(entre ríos)	San Miguel, Entre Ríos
santiago del estero, santa maria	Santa María, Santiago del Estero
santiago del estero, icano	Icaño, Santiago del Estero
santiago del estero, frias	Frías, Santiago del Estero
santiago del estero, anatuya	Añatuya, Santiago del Estero
entre rios, colon	Colón, Entre Ríos
entre rios, san jose	San José, Entre Ríos
entre rios, villa elisa	Villa Elisa, Entre Ríos
entre rios, estancia grande	Estancia Grande, Entre Ríos
entre rios, general roca	General Roca, Entre Ríos
entre rios, concordia	Concordia, Entre Ríos
entre rios, la criolla	La Criolla, Entre Ríos
entre rios, general alvear	General Alvear, Entre Ríos
entre rios, chajari	Chajarí, Entre Ríos
entre rios, federacion	Federación, Entre Ríos
entre rios, san pedro	San Pedro, Entre Ríos
entre rios, santa ana	Santa Ana, Entre Ríos
entre rios, villa del rosario	Villa del Rosario, Entre Ríos
entre rios, gualeguay	Gualeguay, Entre Ríos
entre rios, gualeguaychu	Gualeguaychú, Entre Ríos
entre rios, villa paranacito	Villa Paranacito, Entre Ríos
entre rios, la paz	La Paz, Entre Ríos
entre rios, santa elena	Santa Elena, Entre Ríos
entre rios, aldea santa maria	Aldea Santa María, Entre Ríos
entre rios, parana	Paraná, Entre Ríos
entre rios, las garzas	Las Garzas, Entre Ríos
entre rios, san benito	San Benito, Entre Ríos
entre rios, villa fontana	Villa Fontana, Entre Ríos
entre rios, general campos	General Campos, Entre Ríos
entre rios, san salvador	San Salvador, Entre Ríos
entre rios, rosario del tala	Rosario del Tala, Entre Ríos
entre rios, caseros	Caseros, Entre Ríos
entre rios, concepcion del uruguay	Concepción del Uruguay, Entre Ríos
entre rios, herrera	Herrera, Entre Ríos
entre rios, san justo	San Justo, Entre Ríos
entre rios, victoria	Victoria, Entre Ríos
entre rios, villaguay	Villaguay, Entre Ríos
san juan, san martin	San Martín, San Juan
san juan, santa lucia	Santa Lucía, San Juan
entre rios, san roque	San Roque, Entre Ríos
entre rios, arroyo del medio	Arroyo del Medio, Entre Ríos
entre rios, las toscas	Las Toscas, Entre Ríos
entre rios, santa lucia	Santa Lucía, Entre Ríos
santa cruz, rio gallegos	Río Gallegos, Santa Cruz
entre rios, san miguel	San Miguel, Entre Ríos
santa maria (santiago del estero)	Santa María, Santiago del Estero
icano (santiago del estero)	Icaño, Santiago del Estero
frias (santiago del estero)	Frías, Santiago del Estero
anatuya (santiago del estero)	Añatuya, Santiago del Estero
colon (entre rios)	Colón, Entre Ríos
san jose (entre rios)	San José, Entre Ríos
villa elisa (entre rios)	Villa Elisa, Entre Ríos
estancia grande (entre rios)	Estancia Grande, Entre Ríos
general roca (entre rios)	General Roca, Entre Ríos
concordia (entre rios)	Concordia, Entre Ríos
la criolla (entre rios)	La Criolla, Entre Ríos
general alvear (entre rios)	General Alvear, Entre Ríos
chajari (entre rios)	Chajarí, Entre Ríos
federacion (entre rios)	Federación, Entre Ríos
san pedro (entre rios)	San Pedro, Entre Ríos
santa ana (entre rios)	Santa Ana, Entre Ríos
villa del rosario (entre rios)	Villa del Rosario, Entre Ríos
gualeguay (entre rios)	Gualeguay, Entre Ríos
gualeguaychu (entre rios)	Gualeguaychú, Entre Ríos
villa paranacito (entre rios)	Villa Paranacito, Entre Ríos
la paz (entre rios)	La Paz, Entre Ríos
santa elena (entre rios)	Santa Elena, Entre Ríos
aldea santa maria (entre rios)	Aldea Santa María, Entre Ríos
parana (entre rios)	Paraná, Entre Ríos
las garzas (entre rios)	Las Garzas, Entre Ríos
san benito (entre rios)	San Benito, Entre Ríos
villa fontana (entre rios)	Villa Fontana, Entre Ríos
general campos (entre rios)	General Campos, Entre Ríos
san salvador (entre rios)	San Salvador, Entre Ríos
rosario del tala (entre rios)	Rosario del Tala, Entre Ríos
caseros (entre rios)	Caseros, Entre Ríos
concepcion del uruguay (entre rios)	Concepción del Uruguay, Entre Ríos
herrera (entre rios)	Herrera, Entre Ríos
san justo (entre rios)	San Justo, Entre Ríos
victoria (entre rios)	Victoria, Entre Ríos
villaguay (entre rios)	Villaguay, Entre Ríos
san martin (san juan)	San Martín, San Juan
santa lucia (san juan)	Santa Lucía, San Juan
san roque (entre rios)	San Roque, Entre Ríos
arroyo del medio (entre rios)	Arroyo del Medio, Entre Ríos
las toscas (entre rios)	Las Toscas, Entre Ríos
santa lucia (entre rios)	Santa Lucía, Entre Ríos
rio gallegos (santa cruz)	Río Gallegos, Santa Cruz
san miguel (entre rios)	San Miguel, Entre Ríos
santa maria(santiago del estero)	Santa María, Santiago del Estero
icano(santiago del estero)	Icaño, Santiago del Estero
frias(santiago del estero)	Frías, Santiago del Estero
anatuya(santiago del estero)	Añatuya, Santiago del Estero
colon(entre rios)	Colón, Entre Ríos
san jose(entre rios)	San José, Entre Ríos
villa elisa(entre rios)	Villa Elisa, Entre Ríos
estancia grande(entre rios)	Estancia Grande, Entre Ríos
general roca(entre rios)	General Roca, Entre Ríos
concordia(entre rios)	Concordia, Entre Ríos
la criolla(entre rios)	La Criolla, Entre Ríos
general alvear(entre rios)	General Alvear, Entre Ríos
chajari(entre rios)	Chajarí, Entre Ríos
federacion(entre rios)	Federación, Entre Ríos
san pedro(entre rios)	San Pedro, Entre Ríos
santa ana(entre rios)	Santa Ana, Entre Ríos
villa del rosario(entre rios)	Villa del Rosario, Entre Ríos
gualeguay(entre rios)	Gualeguay, Entre Ríos
gualeguaychu(entre rios)	Gualeguaychú, Entre Ríos
villa paranacito(entre rios)	Villa Paranacito, Entre Ríos
la paz(entre rios)	La Paz, Entre Ríos
santa elena(entre rios)	Santa Elena, Entre Ríos
aldea santa maria(entre rios)	Aldea Santa María, Entre Ríos
parana(entre rios)	Paraná, Entre Ríos
las garzas(entre rios)	Las Garzas, Entre Ríos
san benito(entre rios)	San Benito, Entre Ríos
villa fontana(entre rios)	Villa Fontana, Entre Ríos
general campos(entre rios)	General Campos, Entre Ríos
san salvador(entre rios)	San Salvador, Entre Ríos
rosario del tala(entre rios)	Rosario del Tala, Entre Ríos
caseros(entre rios)	Caseros, Entre Ríos
concepcion del uruguay(entre rios)	Concepción del Uruguay, Entre Ríos
herrera(entre rios)	Herrera, Entre Ríos
san justo(entre rios)	San Justo, Entre Ríos
victoria(entre rios)	Victoria, Entre Ríos
villaguay(entre rios)	Villaguay, Entre Ríos
san martin(san juan)	San Martín, San Juan
santa lucia(san juan)	Santa Lucía, San Juan
san roque(entre rios)	San Roque, Entre Ríos
arroyo del medio(entre rios)	Arroyo del Medio, Entre Ríos
las toscas(entre rios)	Las Toscas, Entre Ríos
santa lucia(entre rios)	Santa Lucía, Entre Ríos
rio gallegos(santa cruz)	Río Gallegos, Santa Cruz
san miguel(entre rios)	San Miguel, Entre Ríos
santiago del estero, santa maría	Santa María, Santiago del Estero
santiago del estero, icaño	Icaño, Santiago del Estero
santiago del estero, frías	Frías, Santiago del Estero
santiago del estero, añatuya	Añatuya, Santiago del Estero
entre ríos, colón	Colón, Entre Ríos
entre ríos, san josé	San José, Entre Ríos
entre ríos, villa elisa	Villa Elisa, Entre Ríos
entre ríos, estancia grande	Estancia Grande, Entre Ríos
entre ríos, general roca	General Roca, Entre Ríos
entre ríos, concordia	Concordia, Entre Ríos
entre ríos, la criolla	La Criolla, Entre Ríos
entre ríos, general alvear	General Alvear, Entre Ríos
entre ríos, chajarí	Chajarí, Entre Ríos
entre ríos, federación	Federación, Entre Ríos
entre ríos, san pedro	San Pedro, Entre Ríos
entre ríos, santa ana	Santa Ana, Entre Ríos
entre ríos, villa del rosario	Villa del Rosario, Entre Ríos
entre ríos, gualeguay	Gualeguay, Entre Ríos
entre ríos, gualeguaychú	Gualeguaychú, Entre Ríos
entre ríos, villa paranacito	Villa Paranacito, Entre Ríos
entre ríos, la paz	La Paz, Entre Ríos
entre ríos, santa elena	Santa Elena, Entre Ríos
entre ríos, aldea santa maría	Aldea Santa María, Entre Ríos
entre ríos, paraná	Paraná, Entre Ríos
entre ríos, las garzas	Las Garzas, Entre Ríos
entre ríos, san benito	San Benito, Entre Ríos
entre ríos, villa fontana	Villa Fontana, Entre Ríos
entre ríos, general campos	General Campos, Entre Ríos
entre ríos, san salvador	San Salvador, Entre Ríos
entre ríos, rosario del tala	Rosario del Tala, Entre Ríos
entre ríos, caseros	Caseros, Entre Ríos
entre ríos, concepción del uruguay	Concepción del Uruguay, Entre Ríos
entre ríos, herrera	Herrera, Entre Ríos
entre ríos, san justo	San Justo, Entre Ríos
entre ríos, victoria	Victoria, Entre Ríos
entre ríos, villaguay	Villaguay, Entre Ríos
san juan, san martín	San Martín, San Juan
san juan, santa lucía	Santa Lucía, San Juan
entre ríos, san roque	San Roque, Entre Ríos
entre ríos, arroyo del medio	Arroyo del Medio, Entre Ríos
entre ríos, las toscas	Las Toscas, Entre Ríos
entre ríos, santa lucía	Santa Lucía, Entre Ríos
santa cruz, río gallegos	Río Gallegos, Santa Cruz
entre ríos, san miguel	San Miguel, Entre Ríos
santa maría (santiago del estero)	Santa María, Santiago del Estero
icaño (santiago del estero)	Icaño, Santiago del Estero
frías (santiago del estero)	Frías, Santiago del Estero
añatuya (santiago del estero)	Añatuya, Santiago del Estero
colón (entre ríos)	Colón, Entre Ríos
san josé (entre ríos)	San José, Entre Ríos
villa elisa (entre ríos)	Villa Elisa, Entre Ríos
estancia grande (entre ríos)	Estancia Grande, Entre Ríos
general roca (entre ríos)	General Roca, Entre Ríos
concordia (entre ríos)	Concordia, Entre Ríos
la criolla (entre ríos)	La Criolla, Entre Ríos
general alvear (entre ríos)	General Alvear, Entre Ríos
chajarí (entre ríos)	Chajarí, Entre Ríos
federación (entre ríos)	Federación, Entre Ríos
san pedro (entre ríos)	San Pedro, Entre Ríos
santa ana (entre ríos)	Santa Ana, Entre Ríos
villa del rosario (entre ríos)	Villa del Rosario, Entre Ríos
gualeguay (entre ríos)	Gualeguay, Entre Ríos
gualeguaychú (entre ríos)	Gualeguaychú, Entre Ríos
villa paranacito (entre ríos)	Villa Paranacito, Entre Ríos
la paz (entre ríos)	La Paz, Entre Ríos
santa elena (entre ríos)	Santa Elena, Entre Ríos
aldea santa maría (entre ríos)	Aldea Santa María, Entre Ríos
paraná (entre ríos)	Paraná, Entre Ríos
las garzas (entre ríos)	Las Garzas, Entre Ríos
san benito (entre ríos)	San Benito, Entre Ríos
villa fontana (entre ríos)	Villa Fontana, Entre Ríos
general campos (entre ríos)	General Campos, Entre Ríos
san salvador (entre ríos)	San Salvador, Entre Ríos
rosario del tala (entre ríos)	Rosario del Tala, Entre Ríos
caseros (entre ríos)	Caseros, Entre Ríos
concepción del uruguay (entre ríos)	Concepción del Uruguay, Entre Ríos
herrera (entre ríos)	Herrera, Entre Ríos
san justo (entre ríos)	San Justo, Entre Ríos
victoria (entre ríos)	Victoria, Entre Ríos
villaguay (entre ríos)	Villaguay, Entre Ríos
san martín (san juan)	San Martín, San Juan
santa lucía (san juan)	Santa Lucía, San Juan
san roque (entre ríos)	San Roque, Entre Ríos
arroyo del medio (entre ríos)	Arroyo del Medio, Entre Ríos
las toscas (entre ríos)	Las Toscas, Entre Ríos
santa lucía (entre ríos)	Santa Lucía, Entre Ríos
río gallegos (santa cruz)	Río Gallegos, Santa Cruz
san miguel (entre ríos)	San Miguel, Entre Ríos
santa maría(santiago del estero)	Santa María, Santiago del Estero
icaño(santiago del estero)	Icaño, Santiago del Estero
frías(santiago del estero)	Frías, Santiago del Estero
añatuya(santiago del estero)	Añatuya, Santiago del Estero
colón(entre ríos)	Colón, Entre Ríos
san josé(entre ríos)	San José, Entre Ríos
villa elisa(entre ríos)	Villa Elisa, Entre Ríos
estancia grande(entre ríos)	Estancia Grande, Entre Ríos
general roca(entre ríos)	General Roca, Entre Ríos
concordia(entre ríos)	Concordia, Entre Ríos
la criolla(entre ríos)	La Criolla, Entre Ríos
general alvear(entre ríos)	General Alvear, Entre Ríos
chajarí(entre ríos)	Chajarí, Entre Ríos
federación(entre ríos)	Federación, Entre Ríos
san pedro(entre ríos)	San Pedro, Entre Ríos
santa ana(entre ríos)	Santa Ana, Entre Ríos
villa del rosario(entre ríos)	Villa del Rosario, Entre Ríos
gualeguay(entre ríos)	Gualeguay, Entre Ríos
gualeguaychú(entre ríos)	Gualeguaychú, Entre Ríos
villa paranacito(entre ríos)	Villa Paranacito, Entre Ríos
la paz(entre ríos)	La Paz, Entre Ríos
santa elena(entre ríos)	Santa Elena, Entre Ríos
aldea santa maría(entre ríos)	Aldea Santa María, Entre Ríos
paraná(entre ríos)	Paraná, Entre Ríos
las garzas(entre ríos)	Las Garzas, Entre Ríos
san benito(entre ríos)	San Benito, Entre Ríos
villa fontana(entre ríos)	Villa Fontana, Entre Ríos
general campos(entre ríos)	General Campos, Entre Ríos
san salvador(entre ríos)	San Salvador, Entre Ríos
rosario del tala(entre ríos)	Rosario del Tala, Entre Ríos
caseros(entre ríos)	Caseros, Entre Ríos
concepción del uruguay(entre ríos)	Concepción del Uruguay, Entre Ríos
herrera(entre ríos)	Herrera, Entre Ríos
san justo(entre ríos)	San Justo, Entre Ríos
victoria(entre ríos)	Victoria, Entre Ríos
villaguay(entre ríos)	Villaguay, Entre Ríos
san martín(san juan)	San Martín, San Juan
santa lucía(san juan)	Santa Lucía, San Juan
san roque(entre ríos)	San Roque, Entre Ríos
arroyo del medio(entre ríos)	Arroyo del Medio, Entre Ríos
las toscas(entre ríos)	Las Toscas, Entre Ríos
santa lucía(entre ríos)	Santa Lucía, Entre Ríos
río gallegos(santa cruz)	Río Gallegos, Santa Cruz
san miguel(entre ríos)	San Miguel, Entre Ríos
agronomia	Buenos Aires
almagro	Buenos Aires
balvanera	Buenos Aires
barracas	Buenos Aires
belgrano	Buenos Aires
boca	Buenos Aires
boedo	Buenos Aires
caballito	Buenos Aires
chacarita	Buenos Aires
coghlan	Buenos Aires
colegiales	Buenos Aires
constitucion	Buenos Aires
flores	Buenos Aires
floresta	Buenos Aires
liniers	Buenos Aires
mataderos	Buenos Aires
monserrat	Buenos Aires
monte castro	Buenos Aires
nueva pompeya	Buenos Aires
nuñez	Buenos Aires
palermo	Buenos Aires
parque avellaneda	Buenos Aires
parque chacabuco	Buenos Aires
parque chas	Buenos Aires
parque patricios	Buenos Aires
paternal	Buenos Aires
puerto madero	Buenos Aires
recoleta	Buenos Aires
retiro	Buenos Aires
san telmo	Buenos Aires
velez sarsfield	Buenos Aires
versalles	Buenos Aires
villa crespo	Buenos Aires
villa del parque	Buenos Aires
villa devoto	Buenos Aires
villa gral. mitre	Buenos Aires
villa lugano	Buenos Aires
villa luro	Buenos Aires
villa ortuzar	Buenos Aires
villa pueyrredon	Buenos Aires
villa real	Buenos Aires
villa riachuelo	Buenos Aires
villa santa rita	Buenos Aires
villa soldati	Buenos Aires
nunez	Buenos Aires
nuñez	Buenos Aires
