alt	name
uttar pradesh	Uttar Pradesh
northern province	Uttar Pradesh
oetarpradesj	Uttar Pradesh
outar prantes	Uttar Pradesh
state of uttar pradesh	Uttar Pradesh
up	Uttar Pradesh
united provinces	Uttar Pradesh
utar pradesas	Uttar Pradesh
utar pradesh	Uttar Pradesh
utar pradexe	Uttar Pradesh
utar pradešas	Uttar Pradesh
utar-pradehsh	Uttar Pradesh
utar-pradeso	Uttar Pradesh
utar-pradeŝo	Uttar Pradesh
utarpradesa	Uttar Pradesh
utarpradēša	Uttar Pradesh
uttar prades	Uttar Pradesh
uttar pradeş	Uttar Pradesh
uttar pradysh	Uttar Pradesh
uttar-pradesh	Uttar Pradesh
uttara pradesa	Uttar Pradesh
uttarprades	Uttar Pradesh
uttarpradesh	Uttar Pradesh
uttarpradéš	Uttar Pradesh
atr brdysh	Uttar Pradesh
atr prdysh	Uttar Pradesh
atrprdysh	Uttar Pradesh
awtar pradsh	Uttar Pradesh
bei fang bang	Uttar Pradesh
rath xuttr prathes	Uttar Pradesh
utaleupeuladesi ju	Uttar Pradesh
utara pradesa	Uttar Pradesh
uttara prades	Uttar Pradesh
uttarap piratecam	Uttar Pradesh
uttarapradesa	Uttar Pradesh
uttarapradesarajyam	Uttar Pradesh
ywtar pyradysh	Uttar Pradesh
maharashtra	Maharashtra
state of mahārāshtra	Maharashtra
state of maharashtra	Maharashtra
mh	Maharashtra
maarastra	Maharashtra
macharastra	Maharashtra
maharastra	Maharashtra
maharastro	Maharashtra
maharasztra	Maharashtra
maharaŝtro	Maharashtra
maharaştra	Maharashtra
maharaštra	Maharashtra
maháraštra	Maharashtra
mahárástra	Maharashtra
maháráštra	Maharashtra
mahārāshtra	Maharashtra
mahārāštra	Maharashtra
makharashhra	Maharashtra
makharashtra	Maharashtra
ma ha la shi te la bang	Maharashtra
mahalasyuteula ju	Maharashtra
mahanrasatara	Maharashtra
maharashutora zhou	Maharashtra
maharastrarajyam	Maharashtra
maharastura	Maharashtra
makarattiram	Maharashtra
mharashtra	Maharashtra
bihar	Bihar
state of bihār	Bihar
state of bihar	Bihar
br	Bihar
biar	Bihar
bichar	Bihar
bihara	Bihar
biharas	Bihar
biharo	Bihar
bihár	Bihar
bihār	Bihar
bihāra	Bihar
bikhar	Bihar
bíhar	Bihar
bhar	Bihar
bi ha er bang	Bihar
bihaleu ju	Bihar
bihararajyam	Bihar
bihari	Bihar
biharu	Bihar
biharu zhou	Bihar
byhr	Bihar
pikar	Bihar
rath phihar	Bihar
west bengal	West Bengal
arevmtyan bengalia	West Bengal
bangla	West Bengal
bati bengal	West Bengal
batis bengal	West Bengal
batys bengal	West Bengal
batı bengal	West Bengal
batıs bengal	West Bengal
beangal thiar	West Bengal
beangál thiar	West Bengal
bengal	West Bengal
bengal rocawani	West Bengal
bengal zachodni	West Bengal
bengala occidental	West Bengal
bengala occidentale	West Bengal
bengala occidentalis	West Bengal
bengala ocidental	West Bengal
bengala rojava	West Bengal
bengale	West Bengal
bengale-occidental	West Bengal
bengalen	West Bengal
bengali perendimor	West Bengal
bengali perëndimor	West Bengal
bengalul de vest	West Bengal
bengaly andrefana	West Bengal
benggala barat	West Bengal
bengoli garbi	West Bengal
dytiki vengali	West Bengal
g'arbiy bengaliya	West Bengal
gorllewin bengal	West Bengal
gʻarbiy bengaliya	West Bengal
iwoorun bengal	West Bengal
katundan nga bengal	West Bengal
kornog bengal	West Bengal
kornôg bengal	West Bengal
kunti banla	West Bengal
laeaene-bengali osariik	West Bengal
laensi-bengali	West Bengal
länsi-bengali	West Bengal
lääne-bengali osariik	West Bengal
malkhbuzera bengali	West Bengal
mendebaldeko bengala	West Bengal
nyugat-bengal	West Bengal
nyugat-bengál	West Bengal
okcident-bengalo	West Bengal
rietumbengale	West Bengal
rietumbengāle	West Bengal
si-men-ka-la-pang	West Bengal
state of west bengal	West Bengal
sî-men-kâ-là-pâng	West Bengal
tay bengal	West Bengal
tây bengal	West Bengal
vaestbengalen	West Bengal
vakaru bengalija	West Bengal
vakarų bengalija	West Bengal
vest bengal	West Bengal
vest-bengal	West Bengal
vestbengalen	West Bengal
vestur-bengal	West Bengal
västbengalen	West Bengal
wb	West Bengal
wast bengal	West Bengal
wes-bengale	West Bengal
west benegal	West Bengal
west-bengalen	West Bengal
westbengalen	West Bengal
zakhidnij bengal	West Bengal
zakhodnjaja bengalija	West Bengal
zapaden bengal	West Bengal
zapadna bengalija	West Bengal
zapadnaja bengalija	West Bengal
zapadne bengalsko	West Bengal
zapadni bengal	West Bengal
zapadni bengalsko	West Bengal
západné bengálsko	West Bengal
západní bengálsko	West Bengal
bangal aftwnyshyn	West Bengal
bngal ghrby	West Bengal
bnghal alghrbyt	West Bengal
bzhadali bengali	West Bengal
dasavleti bengali	West Bengal
lynda bngal	West Bengal
merku vankalam	West Bengal
mghrby bngal	West Bengal
pachami bagala	West Bengal
pascima banga	West Bengal
pascima bangala	West Bengal
pascima bengal	West Bengal
pascimabanga	West Bengal
pascimavangarajyam	West Bengal
rath bengkxl tawan tk	West Bengal
seobeng-gol ju	West Bengal
vestu bengal	West Bengal
xi meng jia la bang	West Bengal
xibengaru zhou	West Bengal
madhya pradesh	Madhya Pradesh
mp	Madhya Pradesh
madhja prades	Madhya Pradesh
madhja pradesa	Madhya Pradesh
madhja pradesas	Madhya Pradesh
madhja pradešas	Madhya Pradesh
madhja pradēša	Madhya Pradesh
madhja-pradeso	Madhya Pradesh
madhja-pradeŝo	Madhya Pradesh
madhjaprades	Madhya Pradesh
madhjapradéš	Madhya Pradesh
madhya prades	Madhya Pradesh
madhya pradesa	Madhya Pradesh
madhya-pradesh	Madhya Pradesh
madia pradexe	Madhya Pradesh
madja pradesh	Madhya Pradesh
madkh'ja-pradesh	Madhya Pradesh
madkhja pradesh	Madhya Pradesh
madkhja-pradehsh	Madhya Pradesh
madkhja-pradesh	Madhya Pradesh
mantia prantes	Madhya Pradesh
state of madhya pradesh	Madhya Pradesh
tung-ong-pang	Madhya Pradesh
tûng-ông-pâng	Madhya Pradesh
madha pradesa	Madhya Pradesh
madhyapradesa	Madhya Pradesh
madhyapradesarajyam	Madhya Pradesh
madiapeuladesi ju	Madhya Pradesh
madya bradysh	Madhya Pradesh
madya prades	Madhya Pradesh
madya pradsh	Madhya Pradesh
mattiyap piratecam	Madhya Pradesh
mdhyh prdysh	Madhya Pradesh
rath mathy prathes	Madhya Pradesh
zhong yang bang	Madhya Pradesh
tamil nadu	Tamil Nadu
state of tamil nādu	Tamil Nadu
state of tamil nadu	Tamil Nadu
coromandela	Tamil Nadu
madras	Tamil Nadu
state of madras	Tamil Nadu
tn	Tamil Nadu
tamil nantou	Tamil Nadu
tamil nādu	Tamil Nadu
tamilagam	Tamil Nadu
tamiland	Tamil Nadu
tamilnad	Tamil Nadu
tamilnada	Tamil Nadu
tamilnadas	Tamil Nadu
tamilnado	Tamil Nadu
tamilnadu	Tamil Nadu
tamilnodu	Tamil Nadu
tamilnádu	Tamil Nadu
tamilnāda	Tamil Nadu
tamishagam	Tamil Nadu
tamizgham	Tamil Nadu
thamizhagam	Tamil Nadu
rath thmil nathu	Tamil Nadu
tai mi er na de bang	Tamil Nadu
tamila nadu	Tamil Nadu
tamila naru	Tamil Nadu
tamilanadu	Tamil Nadu
tamilanadurajyam	Tamil Nadu
tamilanaru	Tamil Nadu
tamilnadu ju	Tamil Nadu
tamilnatu	Tamil Nadu
tamilunadu	Tamil Nadu
tamyl nadw	Tamil Nadu
temil nadu	Tamil Nadu
rajasthan	Rajasthan
state of rājasthān	Rajasthan
state of rajasthan	Rajasthan
rj	Rajasthan
racastan	Rajasthan
radzastan	Rajasthan
radzastana	Rajasthan
radzasthan	Rajasthan
radzasthanas	Rajasthan
radzhastan	Rajasthan
radzhastkhan	Rajasthan
radzsasztan	Rajasthan
radźastan	Rajasthan
radżastan	Rajasthan
radžastan	Rajasthan
radžasthanas	Rajasthan
ragastano	Rajasthan
rajastan	Rajasthan
rajastao	Rajasthan
rajasthana	Rajasthan
rajastán	Rajasthan
rajastão	Rajasthan
ratzastan	Rajasthan
raĝastano	Rajasthan
rojasthon	Rajasthan
rádzsasztán	Rajasthan
rádžasthán	Rajasthan
rādžastāna	Rajasthan
rājasthān	Rajasthan
iracattan	Rajasthan
la gu si tan bang	Rajasthan
lajaseutan ju	Rajasthan
raajasthana	Rajasthan
rajasathana	Rajasthan
rajasthanarajyam	Rajasthan
karnataka	Karnataka
state of karnataka	Karnataka
carnatica	Karnataka
estat de karnataka	Karnataka
ka	Karnataka
karnatako	Karnataka
karnotako	Karnataka
karnátaka	Karnataka
karnātaka	Karnataka
mysore	Karnataka
state of karnātaka	Karnataka
state of mysore	Karnataka
ka na ta ke bang	Karnataka
kaleunataka ju	Karnataka
karanataka	Karnataka
karnatakarajyam	Karnataka
karnnataka	Karnataka
karunataka zhou	Karnataka
karunatakam	Karnataka
rath krnat ka	Karnataka
gujarat	Gujarat
state of gujarāt	Gujarat
state of gujarat	Gujarat
an ghuisearait	Gujarat
an ghúisearáit	Gujarat
gj	Gujarat
gucerat	Gujarat
gucharat	Gujarat
gudzarat	Gujarat
gudzarata	Gujarat
gudzaratas	Gujarat
gudzharat	Gujarat
gudzsarat	Gujarat
gudzsarát	Gujarat
gudźarat	Gujarat
gudžarat	Gujarat
gudžaratas	Gujarat
gudžarát	Gujarat
gudžarāta	Gujarat
guejerat	Gujarat
gugaratio	Gujarat
gujarate	Gujarat
gujarāt	Gujarat
gujrat	Gujarat
guyarat	Gujarat
guzarata	Gujarat
guĝaratio	Gujarat
güjerat	Gujarat
nkoutzarat	Gujarat
ghwjarat	Gujarat
gjrat	Gujarat
gu ji la te bang	Gujarat
gujalateu ju	Gujarat
gujarata	Gujarat
gujaratarajyam	Gujarat
gujarati	Gujarat
gujarato zhou	Gujarat
gujuratu	Gujarat
gwgrʼt	Gujarat
jwjrat	Gujarat
kucarattu	Gujarat
rath khu chra t	Gujarat
andhra pradesh	Andhra Pradesh
seemandhra	Andhra Pradesh
state of andhra pradesh	Andhra Pradesh
ap	Andhra Pradesh
andhra prades	Andhra Pradesh
andhra pradesa	Andhra Pradesh
andhra pradesas	Andhra Pradesh
andhra pradeş	Andhra Pradesh
andhra pradešas	Andhra Pradesh
andhraprades	Andhra Pradesh
andkhra pradesh	Andhra Pradesh
andkhra-pradehsh	Andhra Pradesh
andkhra-pradesh	Andhra Pradesh
andra prades	Andhra Pradesh
andra pradesh	Andhra Pradesh
andra pradex	Andhra Pradesh
andra pradexe	Andhra Pradesh
andra pradeš	Andhra Pradesh
andra-pradeso	Andhra Pradesh
andra-pradeŝo	Andhra Pradesh
antra prantes	Andhra Pradesh
ondra pradish	Andhra Pradesh
an de la bang	Andhra Pradesh
andeulapeuladesi ju	Andhra Pradesh
andhara pradesa	Andhra Pradesh
andhrapradesa	Andhra Pradesh
andhrapradesarajyam	Andhra Pradesh
andra brdysh	Andhra Pradesh
andra pradsh	Andhra Pradesh
andھra prdysh	Andhra Pradesh
antirap piratecam	Andhra Pradesh
rath xan thr prathes	Andhra Pradesh
ándhra prades	Andhra Pradesh
ándhrapradéš	Andhra Pradesh
āndhra pradēša	Andhra Pradesh
odisha	Orissa
state of odisha	Orissa
or	Orissa
orissa	Orissa
state of orissa	Orissa
telangana	Telangana
state of telangāna	Telangana
state of telangana	Telangana
telangana state	Telangana
andhra	Telangana
tg	Telangana
telan'nkana	Telangana
telangano	Telangana
telangána	Telangana
telangāna	Telangana
telanqana	Telangana
telengana	Telangana
telingana	Telangana
thai-lun-ka-nap-pang	Telangana
thai-lùn-kâ-na̍p-pâng	Telangana
télangana	Telangana
rath te lang kha na	Telangana
te lun gan na bang	Telangana
telagana	Telangana
telanganarajyam	Telangana
tellang-gana ju	Telangana
telunkana	Telangana
terangana zhou	Telangana
tlangana	Telangana
tylanghana	Telangana
kerala	Kerala
state of kerala	Kerala
cearala	Kerala
kl	Kerala
keralam	Kerala
keralao	Kerala
kérala	Kerala
malabaria	Kerala
ekaralam	Kerala
ka la la bang	Kerala
kelalla ju	Kerala
keralarajyam	Kerala
kerara zhou	Kerala
kerela	Kerala
krala	Kerala
kyrala	Kerala
kyrla	Kerala
qrlh	Kerala
rath ker la	Kerala
jharkhand	Jharkhand
state of jhārkhand	Jharkhand
state of jharkhand	Jharkhand
dzarkand	Jharkhand
dzharkhand	Jharkhand
dzharkhanda	Jharkhand
dzharkhandas	Jharkhand
dzharkkhand	Jharkhand
dzhkharkkhand	Jharkhand
dzsharkhand	Jharkhand
dzshárkhand	Jharkhand
dźarkand	Jharkhand
džharkhandas	Jharkhand
džhárkhand	Jharkhand
džhārkhanda	Jharkhand
gharkhando	Jharkhand
jh	Jharkhand
jharakhanda	Jharkhand
jhārkhand	Jharkhand
tzarkant	Jharkhand
zharkand	Jharkhand
carkkant	Jharkhand
gu kan de bang	Jharkhand
jaleukandeu ju	Jharkhand
jarkand	Jharkhand
jarkandu	Jharkhand
jarkhand	Jharkhand
jarkhandi	Jharkhand
jarknd	Jharkhand
jarknډ	Jharkhand
jarukando zhou	Jharkhand
jharakhada	Jharkhand
jharakhandarajyam	Jharkhand
rath char khanth	Jharkhand
tjarkand	Jharkhand
ĝharkhando	Jharkhand
assam	Assam
as	Assam
accom	Assam
asam	Assam
asama	Assam
asamas	Assam
asamo	Assam
asom	Assam
asszam	Assam
asszám	Assam
oxom	Assam
state of assam	Assam
a sa mu bang	Assam
acam	Assam
as'sam	Assam
asam ju	Assam
asamarajjam	Assam
asamarajyam	Assam
asamis shtʼatʼi	Assam
assamu zhou	Assam
rath xas sam	Assam
ásam	Assam
ásám	Assam
punjab	Punjab
state of punjab	Punjab
pb	Punjab
pandzab	Punjab
pandzabas	Punjab
pandžab	Punjab
pandžabas	Punjab
pandžáb	Punjab
pangabo	Punjab
panjab	Punjab
panjab i india	Punjab
panjaba	Punjab
pantzab	Punjab
panzhab	Punjab
panĝabo	Punjab
panҷob	Punjab
paňdžáb	Punjab
pendjab	Punjab
pendzab	Punjab
pendzaba	Punjab
pendzhab	Punjab
pendżab	Punjab
pendžāba	Punjab
penjab	Punjab
punjabi suba	Punjab
punyab	Punjab
púnjab	Punjab
pəncab ştatı	Punjab
shtat pendzhab	Punjab
bnjab	Punjab
pajaba	Punjab
pancab	Punjab
pancap	Punjab
pang zhe pu bang	Punjab
panjaba rajya	Punjab
panjabarajyam	Punjab
panjabu	Punjab
panjabu zhou	Punjab
peonjabeu ju	Punjab
pnjab	Punjab
rath payc ab	Punjab
chhattisgarh	Chhatisgarh
state of chhattīsgarh	Chhatisgarh
state of chhattisgarh	Chhatisgarh
ct	Chhatisgarh
catisgar	Chhatisgarh
chatisgar	Chhatisgarh
chatisgarha	Chhatisgarh
chatisgarhas	Chhatisgarh
chatisgaro	Chhatisgarh
chattisagarha	Chhatisgarh
chattisgarh	Chhatisgarh
chhattīsgarh	Chhatisgarh
chkhatisgarkh	Chhatisgarh
chkhattisgarkh	Chhatisgarh
chkhatysgarkh	Chhatisgarh
cshattiszgarh	Chhatisgarh
cshattíszgarh	Chhatisgarh
tsatisnkar	Chhatisgarh
catticukar	Chhatisgarh
chatisagara	Chhatisgarh
chatisagarha	Chhatisgarh
chatiseugaleu ju	Chhatisgarh
chatrisagara	Chhatisgarh
chattichagarha	Chhatisgarh
chattisagadha	Chhatisgarh
chattisagadharajyam	Chhatisgarh
chattisugaru zhou	Chhatisgarh
chtysgr	Chhatisgarh
qia di si jia er bang	Chhatisgarh
rath chat ti skhrh	Chhatisgarh
tshatysghar	Chhatisgarh
ĉhatisgaro	Chhatisgarh
čatisgar	Chhatisgarh
čhatisgarhas	Chhatisgarh
čhattísgarh	Chhatisgarh
čhatīsgarha	Chhatisgarh
haryana	Haryana
state of haryāna	Haryana
state of haryana	Haryana
charyana	Haryana
erjan	Haryana
hr	Haryana
hariana	Haryana
harijana	Haryana
harijána	Haryana
hariyana	Haryana
harjana	Haryana
harjano	Haryana
harjāna	Haryana
haryāna	Haryana
khar'jana	Haryana
kharajana	Haryana
kharjana	Haryana
ariyana	Haryana
ha li ya na bang	Haryana
haliana ju	Haryana
hari'ana	Haryana
hariyana zhou	Haryana
hariyanarajyam	Haryana
rath hr yana	Haryana
uttarakhand	Uttarakhand
state of uttarākhand	Uttarakhand
state of uttarakhand	Uttarakhand
state of uttaranchal	Uttarakhand
ut	Uttarakhand
uttarakhanda	Uttarakhand
uttaranchal	Uttarakhand
uttarākhand	Uttarakhand
himachal pradesh	Himachal Pradesh
state of himāchal pradesh	Himachal Pradesh
state of himachal pradesh	Himachal Pradesh
chimatsal prantes	Himachal Pradesh
hp	Himachal Pradesh
himacal prades	Himachal Pradesh
himacal pradesas	Himachal Pradesh
himacal-pradeso	Himachal Pradesh
himacala pradesa	Himachal Pradesh
himacalprades	Himachal Pradesh
himachal prades	Himachal Pradesh
himachal pradexe	Himachal Pradesh
himacl prdes	Himachal Pradesh
himacsal prades	Himachal Pradesh
himaçhal pradeş	Himachal Pradesh
himaĉal-pradeŝo	Himachal Pradesh
himačal pradeš	Himachal Pradesh
himačal pradešas	Himachal Pradesh
himačl prdeš	Himachal Pradesh
himácsal prades	Himachal Pradesh
himáčalpradéš	Himachal Pradesh
himācala pradeśa	Himachal Pradesh
himāchal pradesh	Himachal Pradesh
himāčala pradēša	Himachal Pradesh
khimachal pradesh	Himachal Pradesh
khimachal-pradehsh	Himachal Pradesh
khimachal-pradesh	Himachal Pradesh
himacalapradesarajyam	Himachal Pradesh
himachalpeuladesi ju	Himachal Pradesh
hymachal pradsh	Himachal Pradesh
hymajl brdysh	Himachal Pradesh
imaccalap piratecam	Himachal Pradesh
rath him acal prathes	Himachal Pradesh
xi ma xie er bang	Himachal Pradesh
tripura	Tripura
state of tripura	Tripura
tr	Tripura
thit-li-phu-la-pang	Tripura
thi̍t-lî-phú-là-pâng	Tripura
tripoera	Tripura
tripoura	Tripura
tripuro	Tripura
trypura	Tripura
rath tri pu ra	Tripura
te li pu la bang	Tripura
teulipula ju	Tripura
tiripura	Tripura
toripura zhou	Tripura
traipuraa	Tripura
traybwra	Tripura
tripurarajyam	Tripura
trypwra	Tripura
trypwrh	Tripura
turipura	Tripura
tyrypwra	Tripura
meghalaya	Meghalaya
meghālaya	Meghalaya
abode of the clouds	Meghalaya
ml	Meghalaya
megalaja	Meghalaya
megalaya	Meghalaya
meghalaj	Meghalaya
meghalaja	Meghalaya
meghalajo	Meghalaya
meghálaj	Meghalaya
meghálaja	Meghalaya
meghālaja	Meghalaya
megkhalaja	Meghalaya
menkalagia	Meghalaya
méghálaja	Meghalaya
state of meghalaya	Meghalaya
state of meghālaya	Meghalaya
megallaya ju	Meghalaya
megaraya zhou	Meghalaya
meghalaia	Meghalaya
meghalayarajyam	Meghalaya
meghali'a	Meghalaya
mei jia la ya bang	Meghalaya
mekalaya	Meghalaya
mgalaya	Meghalaya
myghalaya	Meghalaya
rath mekha lay	Meghalaya
manipur	Manipur
mn	Manipur
manipoer	Manipur
manipour	Manipur
manipura	Manipur
manipuras	Manipur
manipuro	Manipur
manípur	Manipur
state of manipur	Manipur
man ni pu er bang	Manipur
manippur	Manipur
manipuleu ju	Manipur
manipurarajyam	Manipur
manipuru	Manipur
manipuru zhou	Manipur
manybwr	Manipur
manypwr	Manipur
mny pwr	Manipur
mnypwr	Manipur
rath mni pu ra	Manipur
nagaland	Nagaland
state of nāgāland	Nagaland
state of nagaland	Nagaland
nl	Nagaland
naga hills-tuensang area	Nagaland
naga tuensang area	Nagaland
nagafoeld	Nagaland
nagalandas	Nagaland
nagalando	Nagaland
nagalend	Nagaland
nagalenda	Nagaland
nagsko	Nagaland
nankalant	Nagaland
naqalend	Nagaland
nágaföld	Nagaland
nágsko	Nagaland
nágáland	Nagaland
nāga hills-tuensang area	Nagaland
nāgāland	Nagaland
nāgālenda	Nagaland
na jia lan bang	Nagaland
nagalainda	Nagaland
nagalaindarajyam	Nagaland
nagalamda	Nagaland
nagalanda	Nagaland
nagalendi	Nagaland
nagalendu	Nagaland
nagallaendeu ju	Nagaland
nagalnd	Nagaland
nagalyand	Nagaland
nagalyanda	Nagaland
nagarando zhou	Nagaland
najaland	Nagaland
nakalantu	Nagaland
goa	Goa
colonia goa	Goa
cólonia goa	Goa
distrito de goa	Goa
ga	Goa
goi	Goa
goa district	Goa
goa osariik	Goa
goao	Goa
gua	Goa
góa	Goa
nkoa	Goa
qoa	Goa
state of goa	Goa
union territory of goa	Goa
union territory of goa  daman and diu	Goa
union territory of goa  damān and diu	Goa
garaa	Goa
geava	Goa
ghwa	Goa
go'a	Goa
goa ju	Goa
goa zhou	Goa
goaa	Goa
gonya	Goa
goraa	Goa
gova	Goa
govarajyam	Goa
goya	Goa
guo a	Goa
guo a bang	Goa
gwa	Goa
kova	Goa
rath kaw	Goa
daman & diu	Daman & Diu
daman and diu	Daman & Diu
nct of delhi	NCT of Delhi
state of delhi	NCT of Delhi
nct delhi	NCT of Delhi
state of dadra & nagar haveli	Dadra & Nagar Haveli
state of dadra and nagar haveli	Dadra & Nagar Haveli
state of dadara & nagar haveli	Dadra & Nagar Haveli
arunachal pradesh	Arunachal Pradesh
state of arunāchal pradesh	Arunachal Pradesh
state of arunachal pradesh	Arunachal Pradesh
ar	Arunachal Pradesh
arounatsal prantes	Arunachal Pradesh
arunacal prades	Arunachal Pradesh
arunacal pradesas	Arunachal Pradesh
arunacal-pradeso	Arunachal Pradesh
arunacala pradesa	Arunachal Pradesh
arunacalprades	Arunachal Pradesh
arunachal pradexe	Arunachal Pradesh
arunachal-pradehsh	Arunachal Pradesh
arunachal-pradesh	Arunachal Pradesh
arunacsal prades	Arunachal Pradesh
arunaçhal pradesh	Arunachal Pradesh
arunaĉal-pradeŝo	Arunachal Pradesh
arunačal pradeš	Arunachal Pradesh
arunačal pradešas	Arunachal Pradesh
arunácsal prades	Arunachal Pradesh
arunáčalpradéš	Arunachal Pradesh
arunāchal pradesh	Arunachal Pradesh
arunāčala pradēša	Arunachal Pradesh
nefa	Arunachal Pradesh
north east frontier agency	Arunachal Pradesh
north-east frontier tract	Arunachal Pradesh
orunochol pradish	Arunachal Pradesh
a lu na qia er	Arunachal Pradesh
a lu na qia er bang	Arunachal Pradesh
alunachalpeuladesi ju	Arunachal Pradesh
araunacala pradesa	Arunachal Pradesh
arunacalap piratecam	Arunachal Pradesh
arunacalapradesarajyam	Arunachal Pradesh
arwnachal pradsh	Arunachal Pradesh
arwnachl prdysh	Arunachal Pradesh
arwnajl brdysh	Arunachal Pradesh
rath xrun acal prathes	Arunachal Pradesh
mizoram	Mizoram
lushai hills district	Mizoram
mz	Mizoram
mizaram	Mizoram
mizo	Mizoram
mizo district	Mizoram
mizo hills district	Mizoram
mizorama	Mizoram
mizoramas	Mizoram
mizoramo	Mizoram
mizoran	Mizoram
mizorám	Mizoram
mizorán	Mizoram
mizorāma	Mizoram
mizuram	Mizoram
mizóram	Mizoram
state of mizoram	Mizoram
union territory of mizoram	Mizoram
mi zuo la mu bang	Mizoram
micoram	Mizoram
mijhoram	Mizoram
mijhorama	Mizoram
mijolam ju	Mizoram
mijoraama	Mizoram
mijoram	Mizoram
mijorama	Mizoram
mijoramarajyam	Mizoram
misearam	Mizoram
mizorami	Mizoram
mizoramu zhou	Mizoram
myzwram	Mizoram
myzwrm	Mizoram
rath mi so ram	Mizoram
sikkim	Sikkim
che-meng-hsiung	Sikkim
demjong	Sikkim
dremojong	Sikkim
kingdom of sikkim	Sikkim
sk	Sikkim
sikhim	Sikkim
sikim	Sikkim
sikima	Sikkim
sikimas	Sikkim
sikimo	Sikkim
siquim	Sikkim
state of sikkim	Sikkim
szikkim	Sikkim
chikkima	Sikkim
cikkim	Sikkim
rath sikkhim	Sikkim
shikkimu zhou	Sikkim
sikama	Sikkim
sikim ju	Sikkim
sikkima	Sikkim
sikkimarajyam	Sikkim
skkm	Sikkim
skm	Sikkim
sykym	Sikkim
syqym	Sikkim
xi jin	Sikkim
jammu and kashmir	Jammu & Kashmir
state of jammu and kashmīr	Jammu & Kashmir
state of jammu and kashmir	Jammu & Kashmir
cachemire	Jammu & Kashmir
j&k	Jammu & Kashmir
j & k	Jammu & Kashmir
jk	Jammu & Kashmir
jammu & kashmir	Jammu & Kashmir
jammu&kashmir	Jammu & Kashmir
jammu&kashmīr	Jammu & Kashmir
jammu & kashmīr	Jammu & Kashmir
jammu agus an chaismir	Jammu & Kashmir
jammu agus an chaismír	Jammu & Kashmir
jammu and kashmīr	Jammu & Kashmir
jammu og kashmir	Jammu & Kashmir
jammu-et-cachemire	Jammu & Kashmir
kashmir	Jammu & Kashmir
kashmīr	Jammu & Kashmir
jam'mu aura kasmira	Jammu & Kashmir
jamw w kshmyr	Jammu & Kashmir
jamw wkshmyr	Jammu & Kashmir
jamww w kەshmyr	Jammu & Kashmir
jmw aw kshmyr	Jammu & Kashmir
puducherry	Puducherry
union territory of puducherry	Puducherry
l'etat de pondichery	Puducherry
l'état de pondichéry	Puducherry
py	Puducherry
pandyshehry	Puducherry
pondicero	Puducherry
pondicheri	Puducherry
pondicherium	Puducherry
pondicherry	Puducherry
pondisheri	Puducherry
pondiĉero	Puducherry
puducceri	Puducherry
puduccseri	Puducherry
puduceri	Puducherry
puduceris	Puducherry
puducerri	Puducherry
puducherri	Puducherry
puducherry liiduterritoorium	Puducherry
puduçeri	Puducherry
pudučeris	Puducherry
pudučerri	Puducherry
puduččéri	Puducherry
puttuceri	Puducherry
puttučéri	Puducherry
teritorija pondisheri	Puducherry
territoire de pondichery	Puducherry
territoire de pondichéry	Puducherry
union territory of pondicherry	Puducherry
ben de zhi li	Puducherry
bwdwtshyry	Puducherry
pandicari	Puducherry
pandiceri	Puducherry
panticceri	Puducherry
pondiceri	Puducherry
pondisheri lian bang zhi xia ling	Puducherry
pu thuc ce ri	Puducherry
puducheli	Puducherry
putucceri	Puducherry
pwdwchry	Puducherry
pwdwzry	Puducherry
chandigarh	Chandigarh
union territory of chandigarh	Chandigarh
ch	Chandigarh
candigarchas	Chandigarh
candigarh	Chandigarh
candigarha	Chandigarh
candigaro	Chandigarh
chandigar	Chandigarh
chandigarkh	Chandigarh
chandygarkh	Chandigarh
chandīgarh	Chandigarh
csandigarh	Chandigarh
csandígarh	Chandigarh
czandigarh	Chandigarh
tsantinkar	Chandigarh
union territory of chandīgarh	Chandigarh
cadigarha	Chandigarh
candigada	Chandigarh
candigadh	Chandigarh
candigadha	Chandigarh
candigalu	Chandigarh
candigara	Chandigarh
cantikar	Chandigarh
chandigaleu	Chandigarh
chandigarhi	Chandigarh
chandigaru	Chandigarh
chang di jia er	Chandigarh
shandyghar	Chandigarh
çhandigarh	Chandigarh
ĉandigaro	Chandigarh
čandigarchas	Chandigarh
čandígarh	Chandigarh
čandīgarha	Chandigarh
andaman and nicobar islands	Andaman & Nicobar Islands
union territory of andaman and nicobar islands	Andaman & Nicobar Islands
an	Andaman & Nicobar Islands
andamaanit ja nikobaarit	Andaman & Nicobar Islands
andaman & nicobar	Andaman & Nicobar Islands
andaman and nicobar	Andaman & Nicobar Islands
andaman and nicobar island	Andaman & Nicobar Islands
andaman e nicobar	Andaman & Nicobar Islands
andaman et nicobar	Andaman & Nicobar Islands
andaman eta nikobar uharteak	Andaman & Nicobar Islands
andaman kap nicobar kun-to	Andaman & Nicobar Islands
andaman kap nicobar kûn-tó	Andaman & Nicobar Islands
andaman ve nikobar adalari	Andaman & Nicobar Islands
andaman ve nikobar adaları	Andaman & Nicobar Islands
andaman- en nicobar-eilande	Andaman & Nicobar Islands
andaman- es nikobar-szigetek	Andaman & Nicobar Islands
andaman- og nikobareyjar	Andaman & Nicobar Islands
andaman- og níkóbareyjar	Andaman & Nicobar Islands
andamanane og nikobarane	Andaman & Nicobar Islands
andamane e nicobare	Andaman & Nicobar Islands
andamanen en nicobaren	Andaman & Nicobar Islands
andamanen und nikobaren	Andaman & Nicobar Islands
andamanene og nikobarene	Andaman & Nicobar Islands
andamanerna och nikobarerna	Andaman & Nicobar Islands
andamanerne og nicobarerne	Andaman & Nicobar Islands
andamani i nikobari	Andaman & Nicobar Islands
andamanid ja nicobarid	Andaman & Nicobar Islands
andamanoj kaj nikobaroj	Andaman & Nicobar Islands
andamanoyane og nikobarane	Andaman & Nicobar Islands
andamans'ki i nikobars'ki ostrovi	Andaman & Nicobar Islands
andamanski i nikobarski otoci	Andaman & Nicobar Islands
andamanski i nikobarski ostrovi	Andaman & Nicobar Islands
andamanski in nikobarski otoki	Andaman & Nicobar Islands
andamanskie i nikobarskie ostrova	Andaman & Nicobar Islands
andamanskija i nikabarskija astravy	Andaman & Nicobar Islands
andamanu ir nikobaru salos	Andaman & Nicobar Islands
andamanu un nikobaru salas	Andaman & Nicobar Islands
andamany a nikobary	Andaman & Nicobar Islands
andamany i nikobary	Andaman & Nicobar Islands
andamanøyane og nikobarane	Andaman & Nicobar Islands
andamanų ir nikobarų salos	Andaman & Nicobar Islands
andamao e nicobar	Andaman & Nicobar Islands
andamán- és nikobár-szigetek	Andaman & Nicobar Islands
andamão e nicobar	Andaman & Nicobar Islands
awon erekusu andaman ati nicobar	Andaman & Nicobar Islands
iles andaman-et-nicobar	Andaman & Nicobar Islands
illas andaman e nicobar	Andaman & Nicobar Islands
illes andaman i nicobar	Andaman & Nicobar Islands
inizi andaman ha nicobar	Andaman & Nicobar Islands
insulae andamanenses et nicobarenses	Andaman & Nicobar Islands
insulele andaman si nicobar	Andaman & Nicobar Islands
insulele andaman și nicobar	Andaman & Nicobar Islands
islas andaman y nicobar	Andaman & Nicobar Islands
islas andamán y nicobar	Andaman & Nicobar Islands
kapuloan andaman lan nikobar	Andaman & Nicobar Islands
kapuropod-an han andaman ngan nicobar	Andaman & Nicobar Islands
kepulauan andaman dan nicobar	Andaman & Nicobar Islands
kepulauan andaman dan nikobar	Andaman & Nicobar Islands
quan gao andaman va nicobar	Andaman & Nicobar Islands
quần đảo andaman và nicobar	Andaman & Nicobar Islands
ademana ate nikobara tapu	Andaman & Nicobar Islands
an da man-ni ke ba qun dao	Andaman & Nicobar Islands
andaman mattu nikobar dvipagalu	Andaman & Nicobar Islands
andaman nikobaleu jedo	Andaman & Nicobar Islands
andaman nikobar divulu	Andaman & Nicobar Islands
andamana ane nikobara dvipasamuha	Andaman & Nicobar Islands
andamana ani nikobara	Andaman & Nicobar Islands
andamana arau nikobara dbipapunja	Andaman & Nicobar Islands
andamana aura nikobara dvipasamuha	Andaman & Nicobar Islands
andamana baro nikobara dbipamala	Andaman & Nicobar Islands
andamana o nikobara dbipapunja	Andaman & Nicobar Islands
andamana o nikobara dvipapunja	Andaman & Nicobar Islands
andamana ra nikobara dvipa samuha	Andaman & Nicobar Islands
andamananikobaradvipasamuhah	Andaman & Nicobar Islands
andamanish do nikʼobarish kʼokʼepi	Andaman & Nicobar Islands
antaman nikkopar tivukal	Andaman & Nicobar Islands
anڈyman atے nkwbar	Andaman & Nicobar Islands
jzayr andaman w nykwbar	Andaman & Nicobar Islands
jzr andman wnykwbar	Andaman & Nicobar Islands
ladakh	Ladakh
ladakkh	Ladakh
lantach	Ladakh
la da ke	Ladakh
ladak	Ladakh
ladakeu	Ladakh
ladakha	Ladakh
ladakha sampadana	Ladakh
ladaki	Ladakh
laddakha	Ladakh
latak	Ladakh
ldakh	Ladakh
radakku	Ladakh
lakshadweep	Lakshadweep
union territory of lakshadweep	Lakshadweep
ld	Lakshadweep
laccadives	Lakshadweep
lakkadivane	Lakshadweep
lakkadivene	Lakshadweep
laquedives	Lakshadweep
