alt	name
buffalo city metropolitan	Buffalo City Metropolitan
buffalo city metropolitan municipality	Buffalo City Metropolitan
buffalo city	Buffalo City Metropolitan
buffalo	Buffalo City Metropolitan
east london	Buffalo City Metropolitan
nelson mandela bay metropolitan	Nelson Mandela Bay Metropolitan
nelson mandela bay metropolitan municipality	Nelson Mandela Bay Metropolitan
nelson mandela bay	Nelson Mandela Bay Metropolitan
port elizabeth metropolitan	Nelson Mandela Bay Metropolitan
port elizabeth	Nelson Mandela Bay Metropolitan
alfred nzo district	Alfred Nzo District
alfred nzo district municipality	Alfred Nzo District
alfred nzo	Alfred Nzo District
matatiele local	Matatiele Local
matatiele local municipality	Matatiele Local
matatiele municipality	Matatiele Local
matatiele	Matatiele Local
mbizana local	Mbizana Local
mbizana local municipality	Mbizana Local
mbizana municipality	Mbizana Local
mbizana	Mbizana Local
ntabankulu local	Ntabankulu Local
ntabankulu local municipality	Ntabankulu Local
ntabankulu municipality	Ntabankulu Local
ntabankulu	Ntabankulu Local
umzimvubu local	Umzimvubu Local
umzimvubu local municipality	Umzimvubu Local
umzimvubu municipality	Umzimvubu Local
umzimvubu	Umzimvubu Local
amathole district	Amathole District
amathole district municipality	Amathole District
amathole	Amathole District
amahlathi local	Amahlathi Local
amahlathi local municipality	Amahlathi Local
amahlathi municipality	Amahlathi Local
amahlathi	Amahlathi Local
great kei local	Great Kei Local
great kei local municipality	Great Kei Local
great kei municipality	Great Kei Local
great kei	Great Kei Local
mbhashe local	Mbhashe Local
mbhashe local municipality	Mbhashe Local
mbhashe municipality	Mbhashe Local
mbhashe	Mbhashe Local
mnquma local	Mnquma Local
mnquma local municipality	Mnquma Local
mnquma municipality	Mnquma Local
mnquma	Mnquma Local
ngqushwa local	Ngqushwa Local
ngqushwa local municipality	Ngqushwa Local
ngqushwa municipality	Ngqushwa Local
ngqushwa	Ngqushwa Local
raymond mhlaba local	Raymond Mhlaba Local
raymond mhlaba local municipality	Raymond Mhlaba Local
raymond mhlaba municipality	Raymond Mhlaba Local
raymond mhlaba	Raymond Mhlaba Local
nkonkobe local	Raymond Mhlaba Local
nkonkobe local municipality	Raymond Mhlaba Local
nkonkobe municipality	Raymond Mhlaba Local
nkonkobe	Raymond Mhlaba Local
nxuba local	Raymond Mhlaba Local
nxuba local municipality	Raymond Mhlaba Local
nxuba municipality	Raymond Mhlaba Local
nxuba	Raymond Mhlaba Local
chris hani district	Chris Hani District
chris hani district municipality	Chris Hani District
chris hani	Chris Hani District
emalahleni local	Emalahleni Local
emalahleni local municipality	Emalahleni Local
emalahleni municipality	Emalahleni Local
emalahleni	Emalahleni Local
witbank	Emalahleni Local
engcobo local	Engcobo Local
engcobo local municipality	Engcobo Local
engcobo municipality	Engcobo Local
engcobo	Engcobo Local
enoch mgijima local	Enoch Mgijima Local
enoch mgijima local municipality	Enoch Mgijima Local
enoch mgijima municipality	Enoch Mgijima Local
enoch mgijima	Enoch Mgijima Local
tsolwana local	Enoch Mgijima Local
tsolwana local municipality	Enoch Mgijima Local
tsolwana municipality	Enoch Mgijima Local
tsolwana	Enoch Mgijima Local
inkwanca local	Enoch Mgijima Local
inkwanca local municipality	Enoch Mgijima Local
inkwanca municipality	Enoch Mgijima Local
inkwanca	Enoch Mgijima Local
lukhanji local	Enoch Mgijima Local
lukhanji local municipality	Enoch Mgijima Local
lukhanji municipality	Enoch Mgijima Local
lukhanji	Enoch Mgijima Local
intsika yethu local	Intsika Yethu Local
intsika yethu local municipality	Intsika Yethu Local
intsika yethu municipality	Intsika Yethu Local
intsika yethu	Intsika Yethu Local
inxuba yethemba local	Inxuba Yethemba Local
inxuba yethemba local municipality	Inxuba Yethemba Local
inxuba yethemba municipality	Inxuba Yethemba Local
inxuba yethemba	Inxuba Yethemba Local
sakhisizwe local	Sakhisizwe Local
sakhisizwe local municipality	Sakhisizwe Local
sakhisizwe municipality	Sakhisizwe Local
sakhisizwe	Sakhisizwe Local
joe gqabi district	Joe Gqabi District
joe gqabi district municipality	Joe Gqabi District
joe gqabi	Joe Gqabi District
elundini local	Elundini Local
elundini local municipality	Elundini Local
elundini municipality	Elundini Local
elundini	Elundini Local
senqu local	Senqu Local
senqu local municipality	Senqu Local
senqu municipality	Senqu Local
senqu	Senqu Local
walter sisulu local	Walter Sisulu Local
walter sisulu local municipality	Walter Sisulu Local
walter sisulu municipality	Walter Sisulu Local
walter sisulu	Walter Sisulu Local
maletswai local	Walter Sisulu Local
maletswai local municipality	Walter Sisulu Local
maletswai municipality	Walter Sisulu Local
maletswai	Walter Sisulu Local
gariep local	Walter Sisulu Local
gariep local municipality	Walter Sisulu Local
gariep municipality	Walter Sisulu Local
gariep	Walter Sisulu Local
or tambo district	OR Tambo District
or tambo district municipality	OR Tambo District
or tambo	OR Tambo District
o.r. tambo district	OR Tambo District
o.r. tambo district municipality	OR Tambo District
o.r. tambo	OR Tambo District
o.r tambo district	OR Tambo District
o.r tambo district municipality	OR Tambo District
o.r tambo	OR Tambo District
ingquza hill local	Ingquza Hill Local
ingquza hill local municipality	Ingquza Hill Local
ingquza hill municipality	Ingquza Hill Local
ingquza hill	Ingquza Hill Local
ngquza hill	Ingquza Hill Local
king sabata dalindyebo local	King Sabata Dalindyebo Local
king sabata dalindyebo local municipality	King Sabata Dalindyebo Local
king sabata dalindyebo municipality	King Sabata Dalindyebo Local
king sabata dalindyebo	King Sabata Dalindyebo Local
mhlontlo local	Mhlontlo Local
mhlontlo local municipality	Mhlontlo Local
mhlontlo municipality	Mhlontlo Local
mhlontlo	Mhlontlo Local
nyandeni local	Nyandeni Local
nyandeni local municipality	Nyandeni Local
nyandeni municipality	Nyandeni Local
nyandeni	Nyandeni Local
port st johns local	Port St Johns Local
port st johns local municipality	Port St Johns Local
port st johns municipality	Port St Johns Local
port st johns	Port St Johns Local
sarah baartman district	Sarah Baartman District
sarah baartman district municipality	Sarah Baartman District
sarah baartman	Sarah Baartman District
cacadu district	Sarah Baartman District
cacadu district municipality	Sarah Baartman District
cacadu	Sarah Baartman District
blue crane route local	Blue Crane Route Local
blue crane route local municipality	Blue Crane Route Local
blue crane route municipality	Blue Crane Route Local
blue crane route	Blue Crane Route Local
dr beyers naudé local	Dr Beyers Naudé Local
dr beyers naudé local municipality	Dr Beyers Naudé Local
dr beyers naudé municipality	Dr Beyers Naudé Local
dr beyers naude local	Dr Beyers Naudé Local
dr beyers naude local municipality	Dr Beyers Naudé Local
dr beyers naude municipality	Dr Beyers Naudé Local
beyers naudé local	Dr Beyers Naudé Local
beyers naudé local municipality	Dr Beyers Naudé Local
beyers naudé municipality	Dr Beyers Naudé Local
beyers naude local	Dr Beyers Naudé Local
beyers naude local municipality	Dr Beyers Naudé Local
beyers naude municipality	Dr Beyers Naudé Local
camdeboo local	Dr Beyers Naudé Local
camdeboo local municipality	Dr Beyers Naudé Local
camdeboo municipality	Dr Beyers Naudé Local
camdeboo	Dr Beyers Naudé Local
ikwezi local	Dr Beyers Naudé Local
ikwezi local municipality	Dr Beyers Naudé Local
ikwezi municipality	Dr Beyers Naudé Local
ikwezi	Dr Beyers Naudé Local
baviaans local	Dr Beyers Naudé Local
baviaans local municipality	Dr Beyers Naudé Local
baviaans municipality	Dr Beyers Naudé Local
baviaans	Dr Beyers Naudé Local
kouga local	Kouga Local
kouga local municipality	Kouga Local
kouga municipality	Kouga Local
kouga	Kouga Local
koukamma local	Koukamma Local
koukamma local municipality	Koukamma Local
koukamma municipality	Koukamma Local
koukamma	Koukamma Local
kou-kamma local	Koukamma Local
kou-kamma local municipality	Koukamma Local
kou-kamma municipality	Koukamma Local
kou-kamma	Koukamma Local
makana local	Makana Local
makana local municipality	Makana Local
makana municipality	Makana Local
makana	Makana Local
ndlambe local	Ndlambe Local
ndlambe local municipality	Ndlambe Local
ndlambe municipality	Ndlambe Local
ndlambe	Ndlambe Local
sundays river valley local	Sundays River Valley Local
sundays river valley local municipality	Sundays River Valley Local
sundays river valley municipality	Sundays River Valley Local
sundays river valley	Sundays River Valley Local
mangaung metropolitan	Mangaung Metropolitan
mangaung metropolitan municipality	Mangaung Metropolitan
mangaung	Mangaung Metropolitan
city of bloemfontein	Mangaung Metropolitan
bloemfontein city	Mangaung Metropolitan
bloemfontein	Mangaung Metropolitan
bloomfontein	Mangaung Metropolitan
naledi local	Mangaung Metropolitan
naledi local municipality	Mangaung Metropolitan
naledi municipality	Mangaung Metropolitan
naledi	Mangaung Metropolitan
bophelo house	Mangaung Metropolitan
fezile dabi district	Fezile Dabi District
fezile dabi district municipality	Fezile Dabi District
fezile dabi	Fezile Dabi District
mafube local	Mafube Local
mafube local municipality	Mafube Local
mafube municipality	Mafube Local
mafube	Mafube Local
metsimaholo local	Metsimaholo Local
metsimaholo local municipality	Metsimaholo Local
metsimaholo municipality	Metsimaholo Local
metsimaholo	Metsimaholo Local
sasolburg	Metsimaholo Local
moqhaka local	Moqhaka Local
moqhaka local municipality	Moqhaka Local
moqhaka municipality	Moqhaka Local
moqhaka	Moqhaka Local
ngwathe local	Ngwathe Local
ngwathe local municipality	Ngwathe Local
ngwathe municipality	Ngwathe Local
ngwathe	Ngwathe Local
lejweleputswa district	Lejweleputswa District
lejweleputswa district municipality	Lejweleputswa District
lejweleputswa	Lejweleputswa District
masilonyana local	Masilonyana Local
masilonyana local municipality	Masilonyana Local
masilonyana municipality	Masilonyana Local
masilonyana	Masilonyana Local
matjhabeng local	Matjhabeng Local
matjhabeng local municipality	Matjhabeng Local
matjhabeng municipality	Matjhabeng Local
matjhabeng	Matjhabeng Local
hennenman	Matjhabeng Local
phomolong	Matjhabeng Local
nala local	Nala Local
nala local municipality	Nala Local
nala municipality	Nala Local
nala	Nala Local
tokologo local	Tokologo Local
tokologo local municipality	Tokologo Local
tokologo municipality	Tokologo Local
tokologo	Tokologo Local
tswelopele local	Tswelopele Local
tswelopele local municipality	Tswelopele Local
tswelopele municipality	Tswelopele Local
tswelopele	Tswelopele Local
thabo mofutsanyana district	Thabo Mofutsanyana District
thabo mofutsanyana district municipality	Thabo Mofutsanyana District
thabo mofutsanyana	Thabo Mofutsanyana District
dihlabeng local	Dihlabeng Local
dihlabeng local municipality	Dihlabeng Local
dihlabeng municipality	Dihlabeng Local
dihlabeng	Dihlabeng Local
maluti-a-phofung local	Maluti-A-Phofung Local
maluti-a-phofung local municipality	Maluti-A-Phofung Local
maluti-a-phofung municipality	Maluti-A-Phofung Local
maluti-a-phofung	Maluti-A-Phofung Local
mantsopa local	Mantsopa Local
mantsopa local municipality	Mantsopa Local
mantsopa municipality	Mantsopa Local
mantsopa	Mantsopa Local
nketoana local	Nketoana Local
nketoana local municipality	Nketoana Local
nketoana municipality	Nketoana Local
nketoana	Nketoana Local
phumelela local	Phumelela Local
phumelela local municipality	Phumelela Local
phumelela municipality	Phumelela Local
phumelela	Phumelela Local
setsoto local	Setsoto Local
setsoto local municipality	Setsoto Local
setsoto municipality	Setsoto Local
setsoto	Setsoto Local
xhariep district	Xhariep District
xhariep district municipality	Xhariep District
xhariep	Xhariep District
kopanong local	Kopanong Local
kopanong local municipality	Kopanong Local
kopanong municipality	Kopanong Local
kopanong	Kopanong Local
letsemeng local	Letsemeng Local
letsemeng local municipality	Letsemeng Local
letsemeng municipality	Letsemeng Local
letsemeng	Letsemeng Local
mohokare local	Mohokare Local
mohokare local municipality	Mohokare Local
mohokare municipality	Mohokare Local
mohokare	Mohokare Local
city of ekurhuleni metropolitan	City of Ekurhuleni Metropolitan
city of ekurhuleni metropolitan municipality	City of Ekurhuleni Metropolitan
ekurhuleni metropolitan municipality	City of Ekurhuleni Metropolitan
city of ekurhuleni	City of Ekurhuleni Metropolitan
ekurhuleni city	City of Ekurhuleni Metropolitan
ekurhuleni	City of Ekurhuleni Metropolitan
city of germiston	City of Ekurhuleni Metropolitan
germiston	City of Ekurhuleni Metropolitan
germiston city	City of Ekurhuleni Metropolitan
east rand	City of Ekurhuleni Metropolitan
city of johannesburg metropolitan	City of Johannesburg Metropolitan
city of johannesburg metropolitan municipality	City of Johannesburg Metropolitan
johannesburg metropolitan municipality	City of Johannesburg Metropolitan
city of johannesburg	City of Johannesburg Metropolitan
johannesburg city	City of Johannesburg Metropolitan
johannesburg	City of Johannesburg Metropolitan
johanesburg	City of Johannesburg Metropolitan
soweto	City of Johannesburg Metropolitan
alexandra	City of Johannesburg Metropolitan
roodepoort	City of Johannesburg Metropolitan
braamfontein	City of Johannesburg Metropolitan
diepsloot	City of Johannesburg Metropolitan
lenasia	City of Johannesburg Metropolitan
midrand	City of Johannesburg Metropolitan
city of tshwane metropolitan	City of Tshwane Metropolitan
city of tshwane metropolitan municipality	City of Tshwane Metropolitan
tshwane metropolitan municipality	City of Tshwane Metropolitan
city of tshwane	City of Tshwane Metropolitan
tshwane city	City of Tshwane Metropolitan
tshwane	City of Tshwane Metropolitan
metsweding district	City of Tshwane Metropolitan
metsweding district municipality	City of Tshwane Metropolitan
metsweding	City of Tshwane Metropolitan
nokeng tsa taemane local	City of Tshwane Metropolitan
nokeng tsa taemane local municipality	City of Tshwane Metropolitan
nokeng tsa taemane municipality	City of Tshwane Metropolitan
nokeng tsa taemane	City of Tshwane Metropolitan
kungwini local	City of Tshwane Metropolitan
kungwini local municipality	City of Tshwane Metropolitan
kungwini municipality	City of Tshwane Metropolitan
kungwini	City of Tshwane Metropolitan
pretoria city	City of Tshwane Metropolitan
city of pretoria	City of Tshwane Metropolitan
pretoria	City of Tshwane Metropolitan
soshanguve	City of Tshwane Metropolitan
mamelodi	City of Tshwane Metropolitan
marabastad	City of Tshwane Metropolitan
nellmapius	City of Tshwane Metropolitan
garankuwa	City of Tshwane Metropolitan
ga-rankuwa	City of Tshwane Metropolitan
sedibeng district	Sedibeng District
sedibeng district municipality	Sedibeng District
sedibeng	Sedibeng District
emfuleni local	Emfuleni Local
emfuleni local municipality	Emfuleni Local
emfuleni municipality	Emfuleni Local
emfuleni	Emfuleni Local
sebokeng	Emfuleni Local
boiketlong	Emfuleni Local
lesedi local	Lesedi Local
lesedi local municipality	Lesedi Local
lesedi municipality	Lesedi Local
lesedi	Lesedi Local
midvaal local	Midvaal Local
midvaal local municipality	Midvaal Local
midvaal municipality	Midvaal Local
midvaal	Midvaal Local
west rand district	West Rand District
west rand district municipality	West Rand District
west rand	West Rand District
carletonville	West Rand District
merafong city local	Merafong City Local
merafong city local municipality	Merafong City Local
merafong city municipality	Merafong City Local
merafong city	Merafong City Local
merafong	Merafong City Local
khutsong	Merafong City Local
mogale city local	Mogale City Local
mogale city local municipality	Mogale City Local
mogale city municipality	Mogale City Local
mogale city	Mogale City Local
mogale	Mogale City Local
rand west city local	Rand West City Local
rand west city local municipality	Rand West City Local
rand west city municipality	Rand West City Local
rand west city	Rand West City Local
rand west	Rand West City Local
randfontein local	Rand West City Local
randfontein local municipality	Rand West City Local
randfontein municipality	Rand West City Local
randfontein	Rand West City Local
westonaria local	Rand West City Local
westonaria local municipality	Rand West City Local
westonaria municipality	Rand West City Local
westonaria	Rand West City Local
bekkersdal	Rand West City Local
ethekwini metropolitan	eThekwini Metropolitan
ethekwini metropolitan municipality	eThekwini Metropolitan
ethekwini	eThekwini Metropolitan
durban city	eThekwini Metropolitan
city of durban	eThekwini Metropolitan
durban	eThekwini Metropolitan
kwamashu	eThekwini Metropolitan
umlazi	eThekwini Metropolitan
amajuba district	Amajuba District
amajuba district municipality	Amajuba District
amajuba	Amajuba District
dannhauser local	Dannhauser Local
dannhauser local municipality	Dannhauser Local
dannhauser municipality	Dannhauser Local
dannhauser	Dannhauser Local
emadlangeni local	eMadlangeni Local
emadlangeni local municipality	eMadlangeni Local
emadlangeni municipality	eMadlangeni Local
emadlangeni	eMadlangeni Local
newcastle local	Newcastle Local
newcastle local municipality	Newcastle Local
newcastle municipality	Newcastle Local
newcastle	Newcastle Local
harry gwala district	Harry Gwala District
harry gwala district municipality	Harry Gwala District
harry gwala	Harry Gwala District
sisonke district	Harry Gwala District
sisonke district municipality	Harry Gwala District
sisonke	Harry Gwala District
dr nkosazana dlamini zuma local	Dr Nkosazana Dlamini Zuma Local
dr nkosazana dlamini zuma local municipality	Dr Nkosazana Dlamini Zuma Local
dr nkosazana dlamini zuma municipality	Dr Nkosazana Dlamini Zuma Local
dr nkosazana dlamini zuma	Dr Nkosazana Dlamini Zuma Local
dr nkosazana dlamini-zuma local	Dr Nkosazana Dlamini Zuma Local
dr nkosazana dlamini-zuma local municipality	Dr Nkosazana Dlamini Zuma Local
dr nkosazana dlamini-zuma municipality	Dr Nkosazana Dlamini Zuma Local
dr nkosazana dlamini-zuma	Dr Nkosazana Dlamini Zuma Local
dr. nkosazana dlamini zuma	Dr Nkosazana Dlamini Zuma Local
ingwe local	Dr Nkosazana Dlamini Zuma Local
ingwe local municipality	Dr Nkosazana Dlamini Zuma Local
ingwe municipality	Dr Nkosazana Dlamini Zuma Local
ingwe	Dr Nkosazana Dlamini Zuma Local
kwa sani local	Dr Nkosazana Dlamini Zuma Local
kwa sani local municipality	Dr Nkosazana Dlamini Zuma Local
kwa sani municipality	Dr Nkosazana Dlamini Zuma Local
kwa sani	Dr Nkosazana Dlamini Zuma Local
greater kokstad local	Greater Kokstad Local
greater kokstad local municipality	Greater Kokstad Local
greater kokstad municipality	Greater Kokstad Local
greater kokstad	Greater Kokstad Local
ubuhlebezwe local	Ubuhlebezwe Local
ubuhlebezwe local municipality	Ubuhlebezwe Local
ubuhlebezwe municipality	Ubuhlebezwe Local
ubuhlebezwe	Ubuhlebezwe Local
umzimkhulu local	uMzimkhulu Local
umzimkhulu local municipality	uMzimkhulu Local
umzimkhulu municipality	uMzimkhulu Local
umzimkhulu	uMzimkhulu Local
ilembe district	iLembe District
ilembe district municipality	iLembe District
ilembe	iLembe District
kwadukuza local	KwaDukuza Local
kwadukuza local municipality	KwaDukuza Local
kwadukuza municipality	KwaDukuza Local
kwadukuza	KwaDukuza Local
mandeni local	Mandeni Local
mandeni local municipality	Mandeni Local
mandeni municipality	Mandeni Local
mandeni	Mandeni Local
maphumulo local	Maphumulo Local
maphumulo local municipality	Maphumulo Local
maphumulo municipality	Maphumulo Local
maphumulo	Maphumulo Local
ndwedwe local	Ndwedwe Local
ndwedwe local municipality	Ndwedwe Local
ndwedwe municipality	Ndwedwe Local
ndwedwe	Ndwedwe Local
king cetshwayo district	King Cetshwayo District
king cetshwayo district municipality	King Cetshwayo District
king cetshwayo	King Cetshwayo District
king cetswayo district	King Cetshwayo District
king cetswayo district municipality	King Cetshwayo District
king cetswayo	King Cetshwayo District
uthungulu district	King Cetshwayo District
uthungulu district municipality	King Cetshwayo District
uthungulu	King Cetshwayo District
city of umhlathuze local	City of uMhlathuze Local
city of umhlathuze local municipality	City of uMhlathuze Local
city of umhlathuze municipality	City of uMhlathuze Local
city of umhlathuze	City of uMhlathuze Local
umhlathuze city local	City of uMhlathuze Local
umhlathuze city local municipality	City of uMhlathuze Local
umhlathuze city municipality	City of uMhlathuze Local
umhlathuze city	City of uMhlathuze Local
umhlathuze local	City of uMhlathuze Local
umhlathuze local municipality	City of uMhlathuze Local
umhlathuze municipality	City of uMhlathuze Local
umhlathuze	City of uMhlathuze Local
mthonjaneni local	Mthonjaneni Local
mthonjaneni local municipality	Mthonjaneni Local
mthonjaneni municipality	Mthonjaneni Local
mthonjaneni	Mthonjaneni Local
nkandla local	Nkandla Local
nkandla local municipality	Nkandla Local
nkandla municipality	Nkandla Local
nkandla	Nkandla Local
umfolozi local	uMfolozi Local
umfolozi local municipality	uMfolozi Local
umfolozi municipality	uMfolozi Local
umfolozi	uMfolozi Local
mbonambi local	uMfolozi Local
mbonambi local municipality	uMfolozi Local
mbonambi municipality	uMfolozi Local
mbonambi	uMfolozi Local
umlalazi local	uMlalazi Local
umlalazi local municipality	uMlalazi Local
umlalazi municipality	uMlalazi Local
umlalazi	uMlalazi Local
ugu district	Ugu District
ugu district municipality	Ugu District
ugu	Ugu District
ray nkonyeni local	Ray Nkonyeni Local
ray nkonyeni local municipality	Ray Nkonyeni Local
ray nkonyeni municipality	Ray Nkonyeni Local
ray nkonyeni	Ray Nkonyeni Local
ezinqoleni local	Ray Nkonyeni Local
ezinqoleni local municipality	Ray Nkonyeni Local
ezinqoleni municipality	Ray Nkonyeni Local
ezinqoleni	Ray Nkonyeni Local
hibiscus coast local	Ray Nkonyeni Local
hibiscus coast local municipality	Ray Nkonyeni Local
hibiscus coast municipality	Ray Nkonyeni Local
hibiscus coast	Ray Nkonyeni Local
umdoni local	Umdoni Local
umdoni local municipality	Umdoni Local
umdoni municipality	Umdoni Local
umdoni	Umdoni Local
umuziwabantu local	Umuziwabantu Local
umuziwabantu local municipality	Umuziwabantu Local
umuziwabantu municipality	Umuziwabantu Local
umuziwabantu	Umuziwabantu Local
umzumbe local	Umzumbe Local
umzumbe local municipality	Umzumbe Local
umzumbe municipality	Umzumbe Local
umzumbe	Umzumbe Local
umgungundlovu district	uMgungundlovu District
umgungundlovu district municipality	uMgungundlovu District
umgungundlovu	uMgungundlovu District
impendle local	Impendle Local
impendle local municipality	Impendle Local
impendle municipality	Impendle Local
impendle	Impendle Local
mkhambathini local	Mkhambathini Local
mkhambathini local municipality	Mkhambathini Local
mkhambathini municipality	Mkhambathini Local
mkhambathini	Mkhambathini Local
mpofana local	Mpofana Local
mpofana local municipality	Mpofana Local
mpofana municipality	Mpofana Local
mpofana	Mpofana Local
mooi river	Mpofana Local
msunduzi local	Msunduzi Local
msunduzi local municipality	Msunduzi Local
msunduzi municipality	Msunduzi Local
msunduzi	Msunduzi Local
pietermaritzburg	Msunduzi Local
richmond local	Richmond Local
richmond local municipality	Richmond Local
richmond municipality	Richmond Local
richmond	Richmond Local
umngeni local	uMngeni Local
umngeni local municipality	uMngeni Local
umngeni municipality	uMngeni Local
umngeni	uMngeni Local
umshwathi local	uMshwathi Local
umshwathi local municipality	uMshwathi Local
umshwathi municipality	uMshwathi Local
umshwathi	uMshwathi Local
umkhanyakude district	uMkhanyakude District
umkhanyakude district municipality	uMkhanyakude District
umkhanyakude	uMkhanyakude District
big 5 hlabisa local	Big 5 Hlabisa Local
big 5 hlabisa local municipality	Big 5 Hlabisa Local
big 5 hlabisa municipality	Big 5 Hlabisa Local
big 5 hlabisa	Big 5 Hlabisa Local
big five hlabisa local	Big 5 Hlabisa Local
big five hlabisa local municipality	Big 5 Hlabisa Local
big five hlabisa municipality	Big 5 Hlabisa Local
big five hlabisa	Big 5 Hlabisa Local
big 5 false bay local	Big 5 Hlabisa Local
big 5 false bay local municipality	Big 5 Hlabisa Local
big 5 false bay municipality	Big 5 Hlabisa Local
big 5 false bay	Big 5 Hlabisa Local
big five false bay local	Big 5 Hlabisa Local
big five false bay local municipality	Big 5 Hlabisa Local
big five false bay municipality	Big 5 Hlabisa Local
big five false bay	Big 5 Hlabisa Local
hlabisa local	Big 5 Hlabisa Local
hlabisa local municipality	Big 5 Hlabisa Local
hlabisa municipality	Big 5 Hlabisa Local
hlabisa	Big 5 Hlabisa Local
jozini local	Jozini Local
jozini local municipality	Jozini Local
jozini municipality	Jozini Local
jozini	Jozini Local
mtubatuba local	Mtubatuba Local
mtubatuba local municipality	Mtubatuba Local
mtubatuba municipality	Mtubatuba Local
mtubatuba	Mtubatuba Local
umhlabuyalingana local	uMhlabuyalingana Local
umhlabuyalingana local municipality	uMhlabuyalingana Local
umhlabuyalingana municipality	uMhlabuyalingana Local
umhlabuyalingana	uMhlabuyalingana Local
umzinyathi district	uMzinyathi District
umzinyathi district municipality	uMzinyathi District
umzinyathi	uMzinyathi District
endumeni local	Endumeni Local
endumeni local municipality	Endumeni Local
endumeni municipality	Endumeni Local
endumeni	Endumeni Local
nquthu local	Nquthu Local
nquthu local municipality	Nquthu Local
nquthu municipality	Nquthu Local
nquthu	Nquthu Local
umsinga local	uMsinga Local
umsinga local municipality	uMsinga Local
umsinga municipality	uMsinga Local
umsinga	uMsinga Local
msinga local	uMsinga Local
msinga local municipality	uMsinga Local
msinga municipality	uMsinga Local
msinga	uMsinga Local
umvoti local	Umvoti Local
umvoti local municipality	Umvoti Local
umvoti municipality	Umvoti Local
umvoti	Umvoti Local
uthukela district	uThukela District
uthukela district municipality	uThukela District
uthukela	uThukela District
alfred duma local	Alfred Duma Local
alfred duma local municipality	Alfred Duma Local
alfred duma municipality	Alfred Duma Local
alfred duma	Alfred Duma Local
emnambithi/ladysmith local	Alfred Duma Local
emnambithi/ladysmith local municipality	Alfred Duma Local
emnambithi/ladysmith municipality	Alfred Duma Local
emnambithi/ladysmith	Alfred Duma Local
emnambithi-ladysmith local	Alfred Duma Local
emnambithi-ladysmith local municipality	Alfred Duma Local
emnambithi-ladysmith municipality	Alfred Duma Local
emnambithi-ladysmith	Alfred Duma Local
emnambithi ladysmith local	Alfred Duma Local
emnambithi ladysmith local municipality	Alfred Duma Local
emnambithi ladysmith municipality	Alfred Duma Local
emnambithi ladysmith	Alfred Duma Local
emnambithi local	Alfred Duma Local
emnambithi local municipality	Alfred Duma Local
emnambithi municipality	Alfred Duma Local
emnambithi	Alfred Duma Local
ladysmith local	Alfred Duma Local
ladysmith local municipality	Alfred Duma Local
ladysmith municipality	Alfred Duma Local
ladysmith	Alfred Duma Local
indaka local	Alfred Duma Local
indaka local municipality	Alfred Duma Local
indaka municipality	Alfred Duma Local
indaka	Alfred Duma Local
inkosi langalibalele local	Inkosi Langalibalele Local
inkosi langalibalele local municipality	Inkosi Langalibalele Local
inkosi langalibalele municipality	Inkosi Langalibalele Local
inkosi langalibalele	Inkosi Langalibalele Local
umtshezi local	Inkosi Langalibalele Local
umtshezi local municipality	Inkosi Langalibalele Local
umtshezi municipality	Inkosi Langalibalele Local
umtshezi	Inkosi Langalibalele Local
imbabazane local	Inkosi Langalibalele Local
imbabazane local municipality	Inkosi Langalibalele Local
imbabazane municipality	Inkosi Langalibalele Local
imbabazane	Inkosi Langalibalele Local
okhahlamba local	Okhahlamba Local
okhahlamba local municipality	Okhahlamba Local
okhahlamba municipality	Okhahlamba Local
okhahlamba	Okhahlamba Local
zululand district	Zululand District
zululand district municipality	Zululand District
zululand	Zululand District
abaqulusi local	AbaQulusi Local
abaqulusi local municipality	AbaQulusi Local
abaqulusi municipality	AbaQulusi Local
abaqulusi	AbaQulusi Local
edumbe local	eDumbe Local
edumbe local municipality	eDumbe Local
edumbe municipality	eDumbe Local
edumbe	eDumbe Local
nongoma local	Nongoma Local
nongoma local municipality	Nongoma Local
nongoma municipality	Nongoma Local
nongoma	Nongoma Local
ulundi local	Ulundi Local
ulundi local municipality	Ulundi Local
ulundi municipality	Ulundi Local
ulundi	Ulundi Local
uphongolo local	uPhongolo Local
uphongolo local municipality	uPhongolo Local
uphongolo municipality	uPhongolo Local
uphongolo	uPhongolo Local
capricorn district	Capricorn District
capricorn district municipality	Capricorn District
capricorn	Capricorn District
blouberg local	Blouberg Local
blouberg local municipality	Blouberg Local
blouberg municipality	Blouberg Local
blouberg	Blouberg Local
lepelle-nkumpi local	Lepelle-Nkumpi Local
lepelle-nkumpi local municipality	Lepelle-Nkumpi Local
lepelle-nkumpi municipality	Lepelle-Nkumpi Local
lepelle-nkumpi	Lepelle-Nkumpi Local
lepelle/nkumpi local	Lepelle-Nkumpi Local
lepelle/nkumpi local municipality	Lepelle-Nkumpi Local
lepelle/nkumpi municipality	Lepelle-Nkumpi Local
lepelle/nkumpi	Lepelle-Nkumpi Local
lepelle nkumpi local	Lepelle-Nkumpi Local
lepelle nkumpi local municipality	Lepelle-Nkumpi Local
lepelle nkumpi municipality	Lepelle-Nkumpi Local
lepelle nkumpi	Lepelle-Nkumpi Local
molemole local	Molemole Local
molemole local municipality	Molemole Local
molemole municipality	Molemole Local
molemole	Molemole Local
polokwane local	Polokwane Local
polokwane local municipality	Polokwane Local
polokwane municipality	Polokwane Local
polokwane	Polokwane Local
mopani district	Mopani District
mopani district municipality	Mopani District
mopani	Mopani District
ba-phalaborwa local	Ba-Phalaborwa Local
ba-phalaborwa local municipality	Ba-Phalaborwa Local
ba-phalaborwa municipality	Ba-Phalaborwa Local
ba-phalaborwa	Ba-Phalaborwa Local
ba phalaborwa	Ba-Phalaborwa Local
greater giyani local	Greater Giyani Local
greater giyani local municipality	Greater Giyani Local
greater giyani municipality	Greater Giyani Local
greater giyani	Greater Giyani Local
greater letaba local	Greater Letaba Local
greater letaba local municipality	Greater Letaba Local
greater letaba municipality	Greater Letaba Local
greater letaba	Greater Letaba Local
greater tzaneen local	Greater Tzaneen Local
greater tzaneen local municipality	Greater Tzaneen Local
greater tzaneen municipality	Greater Tzaneen Local
greater tzaneen	Greater Tzaneen Local
relela	Greater Tzaneen Local
maruleng local	Maruleng Local
maruleng local municipality	Maruleng Local
maruleng municipality	Maruleng Local
maruleng	Maruleng Local
sekhukhune district	Sekhukhune District
sekhukhune district municipality	Sekhukhune District
sekhukhune	Sekhukhune District
elias motsoaledi local	Elias Motsoaledi Local
elias motsoaledi local municipality	Elias Motsoaledi Local
elias motsoaledi municipality	Elias Motsoaledi Local
elias motsoaledi	Elias Motsoaledi Local
ephraim mogale local	Ephraim Mogale Local
ephraim mogale local municipality	Ephraim Mogale Local
ephraim mogale municipality	Ephraim Mogale Local
ephraim mogale	Ephraim Mogale Local
fetakgomo tubatse local	Fetakgomo Tubatse Local
fetakgomo tubatse local municipality	Fetakgomo Tubatse Local
fetakgomo tubatse municipality	Fetakgomo Tubatse Local
fetakgomo tubatse	Fetakgomo Tubatse Local
fetakgomo/greater tubatse local	Fetakgomo Tubatse Local
fetakgomo/greater tubatse local municipality	Fetakgomo Tubatse Local
fetakgomo/greater tubatse municipality	Fetakgomo Tubatse Local
fetakgomo/greater tubatse	Fetakgomo Tubatse Local
fetakgomo greater tubatse local	Fetakgomo Tubatse Local
fetakgomo greater tubatse local municipality	Fetakgomo Tubatse Local
fetakgomo greater tubatse municipality	Fetakgomo Tubatse Local
fetakgomo greater tubatse	Fetakgomo Tubatse Local
fetakgomo-greater tubatse local	Fetakgomo Tubatse Local
fetakgomo-greater tubatse local municipality	Fetakgomo Tubatse Local
fetakgomo-greater tubatse municipality	Fetakgomo Tubatse Local
fetakgomo-greater tubatse	Fetakgomo Tubatse Local
fetakgomo local	Fetakgomo Tubatse Local
fetakgomo local municipality	Fetakgomo Tubatse Local
fetakgomo municipality	Fetakgomo Tubatse Local
fetakgomo	Fetakgomo Tubatse Local
greater tubatse local	Fetakgomo Tubatse Local
greater tubatse local municipality	Fetakgomo Tubatse Local
greater tubatse municipality	Fetakgomo Tubatse Local
greater tubatse	Fetakgomo Tubatse Local
tubatse local	Fetakgomo Tubatse Local
tubatse local municipality	Fetakgomo Tubatse Local
tubatse municipality	Fetakgomo Tubatse Local
tubatse	Fetakgomo Tubatse Local
makhuduthamaga local	Makhuduthamaga Local
makhuduthamaga local municipality	Makhuduthamaga Local
makhuduthamaga municipality	Makhuduthamaga Local
makhuduthamaga	Makhuduthamaga Local
vhembe district	Vhembe District
vhembe district municipality	Vhembe District
vhembe	Vhembe District
collins chabane local	Collins Chabane Local
collins chabane local municipality	Collins Chabane Local
collins chabane municipality	Collins Chabane Local
collins chabane	Collins Chabane Local
malamulele	Collins Chabane Local
makhado local	Makhado Local
makhado local municipality	Makhado Local
makhado municipality	Makhado Local
makhado	Makhado Local
vuwani	Makhado Local
musina local	Musina Local
musina local municipality	Musina Local
musina municipality	Musina Local
musina	Musina Local
thulamela local	Thulamela Local
thulamela local municipality	Thulamela Local
thulamela municipality	Thulamela Local
thulamela	Thulamela Local
waterberg district	Waterberg District
waterberg district municipality	Waterberg District
waterberg	Waterberg District
bela-bela local	Bela-Bela Local
bela-bela local municipality	Bela-Bela Local
bela-bela municipality	Bela-Bela Local
bela-bela	Bela-Bela Local
bela bela	Bela-Bela Local
lephalale local	Lephalale Local
lephalale local municipality	Lephalale Local
lephalale municipality	Lephalale Local
lephalale	Lephalale Local
medupi power station	Lephalale Local
medupi	Lephalale Local
modimolle-mookgophong local	Modimolle-Mookgophong Local
modimolle-mookgophong local municipality	Modimolle-Mookgophong Local
modimolle-mookgophong municipality	Modimolle-Mookgophong Local
modimolle-mookgophong	Modimolle-Mookgophong Local
modimolle mookgophong local	Modimolle-Mookgophong Local
modimolle mookgophong local municipality	Modimolle-Mookgophong Local
modimolle mookgophong municipality	Modimolle-Mookgophong Local
modimolle mookgophong	Modimolle-Mookgophong Local
modimolle/mookgophong local	Modimolle-Mookgophong Local
modimolle/mookgophong local municipality	Modimolle-Mookgophong Local
modimolle/mookgophong municipality	Modimolle-Mookgophong Local
modimolle/mookgophong	Modimolle-Mookgophong Local
modimolle local	Modimolle-Mookgophong Local
modimolle local municipality	Modimolle-Mookgophong Local
modimolle municipality	Modimolle-Mookgophong Local
modimolle	Modimolle-Mookgophong Local
mookgophong local	Modimolle-Mookgophong Local
mookgophong local municipality	Modimolle-Mookgophong Local
mookgophong municipality	Modimolle-Mookgophong Local
mookgophong	Modimolle-Mookgophong Local
mogalakwena local	Mogalakwena Local
mogalakwena local municipality	Mogalakwena Local
mogalakwena municipality	Mogalakwena Local
mogalakwena	Mogalakwena Local
thabazimbi local	Thabazimbi Local
thabazimbi local municipality	Thabazimbi Local
thabazimbi municipality	Thabazimbi Local
thabazimbi	Thabazimbi Local
ehlanzeni district	Ehlanzeni District
ehlanzeni district municipality	Ehlanzeni District
ehlanzeni	Ehlanzeni District
bushbuckridge local	Bushbuckridge Local
bushbuckridge local municipality	Bushbuckridge Local
bushbuckridge municipality	Bushbuckridge Local
bushbuckridge	Bushbuckridge Local
city of mbombela local	City of Mbombela Local
city of mbombela local municipality	City of Mbombela Local
city of mbombela municipality	City of Mbombela Local
city of mbombela	City of Mbombela Local
mbombela city local	City of Mbombela Local
mbombela city local municipality	City of Mbombela Local
mbombela city municipality	City of Mbombela Local
mbombela city	City of Mbombela Local
mbombela local	City of Mbombela Local
mbombela local municipality	City of Mbombela Local
mbombela municipality	City of Mbombela Local
mbombela	City of Mbombela Local
nelspruit	City of Mbombela Local
umjindi local	City of Mbombela Local
umjindi local municipality	City of Mbombela Local
umjindi municipality	City of Mbombela Local
umjindi	City of Mbombela Local
nkomazi local	Nkomazi Local
nkomazi local municipality	Nkomazi Local
nkomazi municipality	Nkomazi Local
nkomazi	Nkomazi Local
thaba chweu local	Thaba Chweu Local
thaba chweu local municipality	Thaba Chweu Local
thaba chweu municipality	Thaba Chweu Local
thaba chweu	Thaba Chweu Local
gert sibande district	Gert Sibande District
gert sibande district municipality	Gert Sibande District
gert sibande	Gert Sibande District
eastvaal district	Gert Sibande District
eastvaal district municipality	Gert Sibande District
eastvaal	Gert Sibande District
chief albert luthuli local	Chief Albert Luthuli Local
chief albert luthuli local municipality	Chief Albert Luthuli Local
chief albert luthuli municipality	Chief Albert Luthuli Local
chief albert luthuli	Chief Albert Luthuli Local
albert luthuli local	Chief Albert Luthuli Local
albert luthuli local municipality	Chief Albert Luthuli Local
albert luthuli municipality	Chief Albert Luthuli Local
albert luthuli	Chief Albert Luthuli Local
dipaleseng local	Dipaleseng Local
dipaleseng local municipality	Dipaleseng Local
dipaleseng municipality	Dipaleseng Local
dipaleseng	Dipaleseng Local
dr pixley ka isaka seme local	Dr Pixley Ka Isaka Seme Local
dr pixley ka isaka seme local municipality	Dr Pixley Ka Isaka Seme Local
dr pixley ka isaka seme municipality	Dr Pixley Ka Isaka Seme Local
dr pixley ka isaka seme	Dr Pixley Ka Isaka Seme Local
pixley ka isaka seme local	Dr Pixley Ka Isaka Seme Local
pixley ka isaka seme local municipality	Dr Pixley Ka Isaka Seme Local
pixley ka isaka seme municipality	Dr Pixley Ka Isaka Seme Local
pixley ka isaka seme	Dr Pixley Ka Isaka Seme Local
pixley ka seme local	Dr Pixley Ka Isaka Seme Local
pixley ka seme local municipality	Dr Pixley Ka Isaka Seme Local
dr. pixley ka isaka seme	Dr Pixley Ka Isaka Seme Local
govan mbeki local	Govan Mbeki Local
govan mbeki local municipality	Govan Mbeki Local
govan mbeki municipality	Govan Mbeki Local
govan mbeki	Govan Mbeki Local
lekwa local	Lekwa Local
lekwa local municipality	Lekwa Local
lekwa municipality	Lekwa Local
lekwa	Lekwa Local
mkhondo local	Mkhondo Local
mkhondo local municipality	Mkhondo Local
mkhondo municipality	Mkhondo Local
mkhondo	Mkhondo Local
msukaligwa local	Msukaligwa Local
msukaligwa local municipality	Msukaligwa Local
msukaligwa municipality	Msukaligwa Local
msukaligwa	Msukaligwa Local
nkangala district	Nkangala District
nkangala district municipality	Nkangala District
nkangala	Nkangala District
dr js moroka local	Dr JS Moroka Local
dr js moroka local municipality	Dr JS Moroka Local
dr js moroka municipality	Dr JS Moroka Local
dr js moroka	Dr JS Moroka Local
dr. js moroka	Dr JS Moroka Local
emakhazeni local	Emakhazeni Local
emakhazeni local municipality	Emakhazeni Local
emakhazeni municipality	Emakhazeni Local
emakhazeni	Emakhazeni Local
steve tshwete local	Steve Tshwete Local
steve tshwete local municipality	Steve Tshwete Local
steve tshwete municipality	Steve Tshwete Local
steve tshwete	Steve Tshwete Local
thembisile hani local	Thembisile Hani Local
thembisile hani local municipality	Thembisile Hani Local
thembisile hani municipality	Thembisile Hani Local
thembisile hani	Thembisile Hani Local
victor khanye local	Victor Khanye Local
victor khanye local municipality	Victor Khanye Local
victor khanye municipality	Victor Khanye Local
victor khanye	Victor Khanye Local
frances baard district	Frances Baard District
frances baard district municipality	Frances Baard District
frances baard	Frances Baard District
dikgatlong local	Dikgatlong Local
dikgatlong local municipality	Dikgatlong Local
dikgatlong municipality	Dikgatlong Local
dikgatlong	Dikgatlong Local
magareng local	Magareng Local
magareng local municipality	Magareng Local
magareng municipality	Magareng Local
magareng	Magareng Local
phokwane local	Phokwane Local
phokwane local municipality	Phokwane Local
phokwane municipality	Phokwane Local
phokwane	Phokwane Local
sol plaatje local	Sol Plaatje Local
sol plaatje local municipality	Sol Plaatje Local
sol plaatje municipality	Sol Plaatje Local
sol plaatje	Sol Plaatje Local
john taolo gaetsewe district	John Taolo Gaetsewe District
john taolo gaetsewe district municipality	John Taolo Gaetsewe District
john taolo gaetsewe	John Taolo Gaetsewe District
ga-segonyana local	Ga-Segonyana Local
ga-segonyana local municipality	Ga-Segonyana Local
ga-segonyana municipality	Ga-Segonyana Local
ga-segonyana	Ga-Segonyana Local
ga segonyana	Ga-Segonyana Local
gamagara local	Gamagara Local
gamagara local municipality	Gamagara Local
gamagara municipality	Gamagara Local
gamagara	Gamagara Local
joe morolong local	Joe Morolong Local
joe morolong local municipality	Joe Morolong Local
joe morolong municipality	Joe Morolong Local
joe morolong	Joe Morolong Local
namakwa district	Namakwa District
namakwa district municipality	Namakwa District
namakwa	Namakwa District
hantam local	Hantam Local
hantam local municipality	Hantam Local
hantam municipality	Hantam Local
hantam	Hantam Local
kamiesberg local	Kamiesberg Local
kamiesberg local municipality	Kamiesberg Local
kamiesberg municipality	Kamiesberg Local
kamiesberg	Kamiesberg Local
karoo hoogland local	Karoo Hoogland Local
karoo hoogland local municipality	Karoo Hoogland Local
karoo hoogland municipality	Karoo Hoogland Local
karoo hoogland	Karoo Hoogland Local
khai-ma local	Khai-Ma Local
khai-ma local municipality	Khai-Ma Local
khai-ma municipality	Khai-Ma Local
khai-ma	Khai-Ma Local
khai ma	Khai-Ma Local
nama khoi local	Nama Khoi Local
nama khoi local municipality	Nama Khoi Local
nama khoi municipality	Nama Khoi Local
nama khoi	Nama Khoi Local
richtersveld local	Richtersveld Local
richtersveld local municipality	Richtersveld Local
richtersveld municipality	Richtersveld Local
richtersveld	Richtersveld Local
pixley ka seme district	Pixley Ka Seme District
pixley ka seme district municipality	Pixley Ka Seme District
pixley ka seme	Pixley Ka Seme District
emthanjeni local	Emthanjeni Local
emthanjeni local municipality	Emthanjeni Local
emthanjeni municipality	Emthanjeni Local
emthanjeni	Emthanjeni Local
kareeberg local	Kareeberg Local
kareeberg local municipality	Kareeberg Local
kareeberg municipality	Kareeberg Local
kareeberg	Kareeberg Local
renosterberg local	Renosterberg Local
renosterberg local municipality	Renosterberg Local
renosterberg municipality	Renosterberg Local
renosterberg	Renosterberg Local
siyancuma local	Siyancuma Local
siyancuma local municipality	Siyancuma Local
siyancuma municipality	Siyancuma Local
siyancuma	Siyancuma Local
siyathemba local	Siyathemba Local
siyathemba local municipality	Siyathemba Local
siyathemba municipality	Siyathemba Local
siyathemba	Siyathemba Local
thembelihle local	Thembelihle Local
thembelihle local municipality	Thembelihle Local
thembelihle municipality	Thembelihle Local
thembelihle	Thembelihle Local
ubuntu local	Ubuntu Local
ubuntu local municipality	Ubuntu Local
ubuntu municipality	Ubuntu Local
ubuntu	Ubuntu Local
umsobomvu local	Umsobomvu Local
umsobomvu local municipality	Umsobomvu Local
umsobomvu municipality	Umsobomvu Local
umsobomvu	Umsobomvu Local
zf mgcawu district	ZF Mgcawu District
zf mgcawu district municipality	ZF Mgcawu District
zf mgcawu	ZF Mgcawu District
zf-mgcawu district	ZF Mgcawu District
zf-mgcawu district municipality	ZF Mgcawu District
zf-mgcawu	ZF Mgcawu District
siyanda district	ZF Mgcawu District
siyanda district municipality	ZF Mgcawu District
siyanda	ZF Mgcawu District
!kheis local	!Kheis Local
!kheis local municipality	!Kheis Local
!kheis municipality	!Kheis Local
kheis municipality	!Kheis Local
!kheis	!Kheis Local
kheis	!Kheis Local
dawid kruiper local	Dawid Kruiper Local
dawid kruiper local municipality	Dawid Kruiper Local
dawid kruiper municipality	Dawid Kruiper Local
dawid kruiper	Dawid Kruiper Local
mier local	Dawid Kruiper Local
mier local municipality	Dawid Kruiper Local
mier municipality	Dawid Kruiper Local
mier	Dawid Kruiper Local
//khara hais local	Dawid Kruiper Local
//khara hais local municipality	Dawid Kruiper Local
//khara hais municipality	Dawid Kruiper Local
//khara hais	Dawid Kruiper Local
khara hais local	Dawid Kruiper Local
khara hais local municipality	Dawid Kruiper Local
khara hais municipality	Dawid Kruiper Local
khara hais	Dawid Kruiper Local
kai !garib local	Kai !Garib Local
kai !garib local municipality	Kai !Garib Local
kai !garib municipality	Kai !Garib Local
kai garib municipality	Kai !Garib Local
kai !garib	Kai !Garib Local
kai garib	Kai !Garib Local
kgatelopele local	Kgatelopele Local
kgatelopele local municipality	Kgatelopele Local
kgatelopele municipality	Kgatelopele Local
kgatelopele	Kgatelopele Local
tsantsabane local	Tsantsabane Local
tsantsabane local municipality	Tsantsabane Local
tsantsabane municipality	Tsantsabane Local
tsantsabane	Tsantsabane Local
bojanala platinum district	Bojanala Platinum District
bojanala platinum district municipality	Bojanala Platinum District
bojanala platinum	Bojanala Platinum District
kgetlengrivier local	Kgetlengrivier Local
kgetlengrivier local municipality	Kgetlengrivier Local
kgetlengrivier municipality	Kgetlengrivier Local
kgetlengrivier	Kgetlengrivier Local
kgetleng river local	Kgetlengrivier Local
kgetleng river local municipality	Kgetlengrivier Local
kgetleng river municipality	Kgetlengrivier Local
kgetleng river	Kgetlengrivier Local
madibeng local	Madibeng Local
madibeng local municipality	Madibeng Local
madibeng municipality	Madibeng Local
madibeng	Madibeng Local
brits	Madibeng Local
wonderkop	Madibeng Local
mothutlung	Madibeng Local
moretele local	Moretele Local
moretele local municipality	Moretele Local
moretele municipality	Moretele Local
moretele	Moretele Local
moses kotane local	Moses Kotane Local
moses kotane local municipality	Moses Kotane Local
moses kotane municipality	Moses Kotane Local
moses kotane	Moses Kotane Local
rustenburg local	Rustenburg Local
rustenburg local municipality	Rustenburg Local
rustenburg municipality	Rustenburg Local
rustenburg	Rustenburg Local
khuseleka	Rustenburg Local
marikana	Rustenburg Local
rooikoppies	Rustenburg Local
nkaneng	Rustenburg Local
boitekong	Rustenburg Local
rustenburg civic centre	Rustenburg Local
dr kenneth kaunda district	Dr Kenneth Kaunda District
dr kenneth kaunda district municipality	Dr Kenneth Kaunda District
dr kenneth kaunda	Dr Kenneth Kaunda District
dr. kenneth kaunda	Dr Kenneth Kaunda District
city of matlosana local	City of Matlosana Local
city of matlosana local municipality	City of Matlosana Local
city of matlosana municipality	City of Matlosana Local
city of matlosana	City of Matlosana Local
matlosana city local	City of Matlosana Local
matlosana city local municipality	City of Matlosana Local
matlosana city municipality	City of Matlosana Local
matlosana city	City of Matlosana Local
matlosana local	City of Matlosana Local
matlosana local municipality	City of Matlosana Local
matlosana municipality	City of Matlosana Local
matlosana	City of Matlosana Local
jb marks local	JB Marks Local
jb marks local municipality	JB Marks Local
jb marks municipality	JB Marks Local
jb marks	JB Marks Local
potchefstroom local	JB Marks Local
potchefstroom local municipality	JB Marks Local
potchefstroom municipality	JB Marks Local
potchefstroom	JB Marks Local
ventersdorp local	JB Marks Local
ventersdorp local municipality	JB Marks Local
ventersdorp municipality	JB Marks Local
ventersdorp	JB Marks Local
tlokwe local	JB Marks Local
tlokwe local municipality	JB Marks Local
tlokwe municipality	JB Marks Local
tlokwe	JB Marks Local
ventersdorp/tlokwe local	JB Marks Local
ventersdorp/tlokwe local municipality	JB Marks Local
ventersdorp/tlokwe municipality	JB Marks Local
ventersdorp/tlokwe	JB Marks Local
maquassi hills local	Maquassi Hills Local
maquassi hills local municipality	Maquassi Hills Local
maquassi hills municipality	Maquassi Hills Local
maquassi hills	Maquassi Hills Local
dr ruth segomotsi mompati district	Dr Ruth Segomotsi Mompati District
dr ruth segomotsi mompati district municipality	Dr Ruth Segomotsi Mompati District
dr ruth segomotsi mompati	Dr Ruth Segomotsi Mompati District
dr. ruth segomotsi mompati	Dr Ruth Segomotsi Mompati District
bophirima district	Dr Ruth Segomotsi Mompati District
bophirima district municipality	Dr Ruth Segomotsi Mompati District
bophirima	Dr Ruth Segomotsi Mompati District
bophirima	Dr Ruth Segomotsi Mompati District
greater taung local	Greater Taung Local
greater taung local municipality	Greater Taung Local
greater taung municipality	Greater Taung Local
greater taung	Greater Taung Local
kagisano-molopo local	Kagisano-Molopo Local
kagisano-molopo local municipality	Kagisano-Molopo Local
kagisano-molopo municipality	Kagisano-Molopo Local
kagisano-molopo	Kagisano-Molopo Local
kagisano/molopo local	Kagisano-Molopo Local
kagisano/molopo local municipality	Kagisano-Molopo Local
kagisano/molopo municipality	Kagisano-Molopo Local
kagisano/molopo	Kagisano-Molopo Local
kagisano molopo local	Kagisano-Molopo Local
kagisano molopo local municipality	Kagisano-Molopo Local
kagisano molopo municipality	Kagisano-Molopo Local
kagisano molopo	Kagisano-Molopo Local
kagisano local	Kagisano-Molopo Local
kagisano local municipality	Kagisano-Molopo Local
kagisano municipality	Kagisano-Molopo Local
kagisano	Kagisano-Molopo Local
molopo local	Kagisano-Molopo Local
molopo local municipality	Kagisano-Molopo Local
molopo municipality	Kagisano-Molopo Local
molopo	Kagisano-Molopo Local
lekwa-teemane local	Lekwa-Teemane Local
lekwa-teemane local municipality	Lekwa-Teemane Local
lekwa-teemane municipality	Lekwa-Teemane Local
lekwa-teemane	Lekwa-Teemane Local
lekwa/teemane local	Lekwa-Teemane Local
lekwa/teemane local municipality	Lekwa-Teemane Local
lekwa/teemane municipality	Lekwa-Teemane Local
lekwa/teemane	Lekwa-Teemane Local
lekwa teemane local	Lekwa-Teemane Local
lekwa teemane local municipality	Lekwa-Teemane Local
lekwa teemane municipality	Lekwa-Teemane Local
lekwa teemane	Lekwa-Teemane Local
boitumelong	Lekwa-Teemane Local
bloemhof	Lekwa-Teemane Local
mamusa local	Mamusa Local
mamusa local municipality	Mamusa Local
mamusa municipality	Mamusa Local
mamusa	Mamusa Local
naledi local	Naledi Local
naledi local municipality	Naledi Local
naledi municipality	Naledi Local
naledi	Naledi Local
ngaka modiri molema district	Ngaka Modiri Molema District
ngaka modiri molema district municipality	Ngaka Modiri Molema District
ngaka modiri molema	Ngaka Modiri Molema District
ditsobotla local	Ditsobotla Local
ditsobotla local municipality	Ditsobotla Local
ditsobotla municipality	Ditsobotla Local
ditsobotla	Ditsobotla Local
coligny	Ditsobotla Local
mahikeng local	Mahikeng Local
mahikeng local municipality	Mahikeng Local
mahikeng municipality	Mahikeng Local
mahikeng	Mahikeng Local
mafeking local	Mahikeng Local
mafeking local municipality	Mahikeng Local
mafeking municipality	Mahikeng Local
mafeking	Mahikeng Local
mafikeng local	Mahikeng Local
mafikeng local municipality	Mahikeng Local
mafikeng municipality	Mahikeng Local
mafikeng	Mahikeng Local
ramotshere moiloa local	Ramotshere Moiloa Local
ramotshere moiloa local municipality	Ramotshere Moiloa Local
ramotshere moiloa municipality	Ramotshere Moiloa Local
ramotshere moiloa	Ramotshere Moiloa Local
ratlou local	Ratlou Local
ratlou local municipality	Ratlou Local
ratlou municipality	Ratlou Local
ratlou	Ratlou Local
tswaing local	Tswaing Local
tswaing local municipality	Tswaing Local
tswaing municipality	Tswaing Local
tswaing	Tswaing Local
city of cape town metropolitan	City of Cape Town Metropolitan
city of cape town metropolitan municipality	City of Cape Town Metropolitan
cape town metropolitan municipality	City of Cape Town Metropolitan
city of cape town	City of Cape Town Metropolitan
cape town city	City of Cape Town Metropolitan
cape town	City of Cape Town Metropolitan
khayelitsha	City of Cape Town Metropolitan
mitchells plain	City of Cape Town Metropolitan
mitchell's plain	City of Cape Town Metropolitan
mitchell 's plain	City of Cape Town Metropolitan
cape winelands district	Cape Winelands District
cape winelands district municipality	Cape Winelands District
cape winelands	Cape Winelands District
breede valley local	Breede Valley Local
breede valley local municipality	Breede Valley Local
breede valley municipality	Breede Valley Local
breede valley	Breede Valley Local
de doorns	Breede Valley Local
doorns	Breede Valley Local
hex river valley	Breede Valley Local
hex river pass	Breede Valley Local
touws river	Breede Valley Local
touws	Breede Valley Local
drakenstein local	Drakenstein Local
drakenstein local municipality	Drakenstein Local
drakenstein municipality	Drakenstein Local
drakenstein	Drakenstein Local
langeberg local	Langeberg Local
langeberg local municipality	Langeberg Local
langeberg municipality	Langeberg Local
langeberg	Langeberg Local
stellenbosch local	Stellenbosch Local
stellenbosch local municipality	Stellenbosch Local
stellenbosch municipality	Stellenbosch Local
stellenbosch	Stellenbosch Local
witzenberg local	Witzenberg Local
witzenberg local municipality	Witzenberg Local
witzenberg municipality	Witzenberg Local
witzenberg	Witzenberg Local
central karoo district	Central Karoo District
central karoo district municipality	Central Karoo District
central karoo	Central Karoo District
beaufort west local	Beaufort West Local
beaufort west local municipality	Beaufort West Local
beaufort west municipality	Beaufort West Local
beaufort west	Beaufort West Local
laingsburg local	Laingsburg Local
laingsburg local municipality	Laingsburg Local
laingsburg municipality	Laingsburg Local
laingsburg	Laingsburg Local
prince albert local	Prince Albert Local
prince albert local municipality	Prince Albert Local
prince albert municipality	Prince Albert Local
prince albert	Prince Albert Local
garden route district	Garden Route District
garden route district municipality	Garden Route District
garden route	Garden Route District
eden district	Garden Route District
eden district municipality	Garden Route District
eden	Garden Route District
bitou local	Bitou Local
bitou local municipality	Bitou Local
bitou municipality	Bitou Local
bitou	Bitou Local
george local	George Local
george local municipality	George Local
george municipality	George Local
george	George Local
hessequa local	Hessequa Local
hessequa local municipality	Hessequa Local
hessequa municipality	Hessequa Local
hessequa	Hessequa Local
kannaland local	Kannaland Local
kannaland local municipality	Kannaland Local
kannaland municipality	Kannaland Local
kannaland	Kannaland Local
knysna local	Knysna Local
knysna local municipality	Knysna Local
knysna municipality	Knysna Local
knysna	Knysna Local
mossel bay local	Mossel Bay Local
mossel bay local municipality	Mossel Bay Local
mossel bay municipality	Mossel Bay Local
mossel bay	Mossel Bay Local
oudtshoorn local	Oudtshoorn Local
oudtshoorn local municipality	Oudtshoorn Local
oudtshoorn municipality	Oudtshoorn Local
oudtshoorn	Oudtshoorn Local
overberg district	Overberg District
overberg district municipality	Overberg District
overberg	Overberg District
cape agulhas local	Cape Agulhas Local
cape agulhas local municipality	Cape Agulhas Local
cape agulhas municipality	Cape Agulhas Local
cape agulhas	Cape Agulhas Local
overstrand local	Overstrand Local
overstrand local municipality	Overstrand Local
overstrand municipality	Overstrand Local
overstrand	Overstrand Local
swellendam local	Swellendam Local
swellendam local municipality	Swellendam Local
swellendam municipality	Swellendam Local
swellendam	Swellendam Local
theewaterskloof local	Theewaterskloof Local
theewaterskloof local municipality	Theewaterskloof Local
theewaterskloof municipality	Theewaterskloof Local
theewaterskloof	Theewaterskloof Local
west coast district	West Coast District
west coast district municipality	West Coast District
west coast	West Coast District
bergrivier local	Bergrivier Local
bergrivier local municipality	Bergrivier Local
bergrivier municipality	Bergrivier Local
bergrivier	Bergrivier Local
cederberg local	Cederberg Local
cederberg local municipality	Cederberg Local
cederberg municipality	Cederberg Local
cederberg	Cederberg Local
matzikama local	Matzikama Local
matzikama local municipality	Matzikama Local
matzikama municipality	Matzikama Local
matzikama	Matzikama Local
saldanha bay local	Saldanha Bay Local
saldanha bay local municipality	Saldanha Bay Local
saldanha bay municipality	Saldanha Bay Local
saldanha bay	Saldanha Bay Local
swartland local	Swartland Local
swartland local municipality	Swartland Local
swartland municipality	Swartland Local
swartland	Swartland Local